fear: fear 
damn: damn 
tradu: tradu 
isosine: isosine 
italic: italics 
important: important 
woo: woo 
chorus: chorus 
still: still 
section: section 
nobody: nobody 
let: let 
terrell: terrell 
remixes: remixes 
little: little 
none: none 
traductions: traductions 
bully: bully 
collection: collection 
woman: woman 
use: use 
lyric: lyrics lyric 
bad: bad 
give: give 
deep: deep 
chill: chill 
information: information 
significantly: significantly 
loyalty: loyalty 
boy: boy 
fianc: fianc 
w: w 
scherrer: scherrer 
world: world 
holding: holdings 
rick: rick 
traduction: traduction 
presumably: presumably 
oh: oh 
v: v 
twice: twice 
page: page 
curve: curves 
wanna: wanna 
pressure: pressure 
alex: alex 
asking: asking 
nathan: nathan 
privacy: privacy 
artist: artists 
want: want 
curb: curb 
ayy: ayy 
nonstop: nonstop 
loved: loved 
go: go 
juxtaposes: juxtaposes 
another: another 
color: color 
humble: humble 
run: run 
motorsport: motorsport 
answer: answer 
share: share 
outrun: outrun 
jamie: jamie 
k: k 
think: think 
guideline: guidelines 
check: check 
song: song songs 
credit: credits 
going: going 
even: even 
engineer: engineer 
liar: liar 
rabineau: rabineau 
function: function 
money: money 
soup: soup 
comment: comment comments 
element: element 
commentary: commentary 
wan: wan 
contributor: contributor contributors 
mom: mom 
read: read 
word: word 
xxx: xxx 
part: parts part 
free: free 
blk: blk 
header: headers 
next: next 
sin: sins 
ask: ask 
written: written 
performance: performance performances 
va: va 
format: format 
vocalist: vocalists 
developer: developers 
kiddin: kiddin 
limit: limit 
phonographic: phonographic 
director: director 
remix: remix 
mixing: mixing 
view: view 
musical: musical 
tyler: tyler 
visit: visit 
lust: lust 
created: created 
studio: studio 
theme: theme 
p: p 
partner: partner 
play: play 
killed: killed 
uh: uh 
gengahr: gengahr 
allegro: allegro 
leaked: leaked 
broken: broken 
different: different 
devvon: devvon 
remember: remember 
gardena: gardena 
feelin: feelin 
bought: bought 
sexual: sexual 
e: es e 
video: videos video 
concept: concept 
featured: featured 
album: album 
tag: tags 
nothin: nothin 
ride: ride 
grant: grants 
label: label 
today: today 
hol: hol 
ballad: ballad 
ascap: ascap 
al: al 
us: uses 
got: got 
coast: coast 
type: type 
duckworth: duckworth 
release: release 
b: b 
lean: lean 
right: rights 
would: would 
jason: jason 
bmi: bmi 
stem: stems 
together: together 
intro: intro 
french: french 
earth: earth 
nanny: nanny 
x: x 
one: one 
feel: feels feel 
transcriber: transcribers 
night: night 
away: away 
prior: prior 
bubbly: bubbly 
policy: policy 
publisher: publisher 
future: future 
saxaphone: saxaphone 
kendrick: kendrick 
ten: ten 
production: productions 
etc: etc 
sell: sell 
fran: fran 
took: took 
portugu: portugu 
greg: greg 
lovely: lovely 
smooth: smooth 
process: process 
annotation: annotation 
blessing: blessing 
told: told 
genius: genius 
somethin: somethin 
sample: samples sample 
featuring: featuring 
year: year 
day: days day 
press: press 
rap: rap 
worked: worked 
pt: pt 
mike: mike 
title: title titles 
babe: babe 
homie: homie 
gon: gon 
meyers: meyers 
u: u us 
verified: verified 
n: n 
g: g 
shoulder: shoulder 
phone: phone 
futuristic: futuristic 
mixed: mixed 
sounwave: sounwave 
room: room 
pride: pride 
knowledge: knowledge 
backstroke: backstroke 
seven: seven 
find: finds find 
west: west 
death: death 
line: lines 
brasil: brasil 
licensing: licensing 
j: j 
assistant: assistant 
sony: sony 
life: life 
yo: yo 
attitude: attitude 
sent: sent 
minimized: minimized 
assumption: assumptions 
ol: ol 
forum: forum 
late: late 
traducciones: traducciones 
zacari: zacari 
jammin: jammin 
said: said 
mad: mad 
advertise: advertise 
toward: toward 
ai: aises ais 
dawg: dawg 
additional: additional 
add: add 
songwriting: songwriting 
musing: musing 
alford: alford 
dean: dean 
understand: understand 
rather: rather 
guide: guide 
encompasses: encompasses 
blood: blood 
school: school 
promote: promote 
hip: hip hips 
kobalt: kobalt 
copyright: copyright 
hundred: hundred 
biggest: biggest 
quelly: quelly 
job: jobs 
bold: bold 
link: link 
f: f 
acoustic: acoustic 
cami: cami 
dammit: dammit 
chappell: chappell 
contact: contact 
em: em 
session: session 
ml: ml 
wrap: wraps 
also: also 
get: get 
played: played 
translation: translations translation 
khaled: khaled 
traducci: traducci 
connection: connection 
body: body 
nicki: nicki 
comin: comin 
fact: facts 
contrast: contrasts 
end: end 
mood: mood 
vague: vague 
cancel: cancel 
z: z 
high: high 
record: record records 
come: come 
solidify: solidify 
whitney: whitney 
mastering: mastering 
way: way 
emi: emi 
look: look 
party: party 
made: made 
top: top 
ali: ali 
career: career 
interscope: interscope 
term: terms 
open: open 
black: black 
lamar: lamar 
tune: tunes 
majority: majority 
god: god 
hop: hop 
keep: keep 
livin: livin 
aise: aise 
embed: embed 
whole: whole 
dna: dna 
poppin: poppin 
ft: ft 
worth: worth 
time: time 
last: last 
aftermath: aftermath 
sweeplings: sweeplings 
walton: walton 
homies: homies 
spliff: spliff 
hot: hot 
essential: essential 
influence: influences 
camry: camry 
since: since 
ultimate: ultimate 
tyson: tyson 
refrain: refrain 
like: like 
distinguish: distinguish 
folk: folks 
trust: trust 
cover: covers 
filthy: filthy 
question: questions question 
follow: follow 
source: source 
intimate: intimate 
need: need 
sign: sign 
q: q 
pop: pop 
r: r 
favorite: favorite 
spanish: spanish 
asked: asked 
llc: llc 
hund: hund 
ross: ross 
insight: insight 
working: working 
gum: gum 
ya: ya 
ray: ray 
expand: expand 
big: big 
sippin: sippin 
waste: waste 
april: april 
yah: yah 
portuguese: portuguese 
already: already 
dave: dave 
capri: capri 
repeating: repeating 
premiere: premiere 
completely: completely 
track: track 
teddy: teddy 
love: love 
desire: desires 
hit: hit 
publishing: publishing 
date: date 
emotion: emotion 
girl: girls 
send: send 
c: c 
relationship: relationship 
yep: yep 
conscious: conscious 
blade: blade 
mashup: mashup 
h: h 
individual: individual 
engaged: engaged 
prove: prove 
know: know 
personal: personal 
kurstin: kurstin 
minaj: minaj 
transcription: transcription 
chart: charts 
might: might 
bozzi: bozzi 
hard: hard 
bradley: bradley 
happens: happens 
yeah: yeah 
aiono: aiono 
baum: baum 
pick: pick 
warner: warner 
vocal: vocals 
finesse: finesse 
oversea: oversea 
aspect: aspect 
music: music 
l: l 
door: door 
live: live 
kept: kept 
knock: knock 
kid: kid 
preceding: preceding 
complete: complete 
producer: producer 
instrument: instruments 
drop: drop 
shop: shop 
espa: espa 
feeling: feeling 
produced: produced 
learn: learn 
verse: verse 
ahead: ahead 
dj: dj 
scholar: scholars 
initially: initially 
kind: kind 
interpolation: interpolations 
mammy: mammy 
abrasive: abrasive 
deadly: deadly 
exit: exit 
drought: drought 
entertainment: entertainment 
net: net 
sh: sh 
beat: beat 
physical: physical 
atv: atv 
