onetakedrew: onetakedrew 
double: double 
nightmare: nightmare 
foreign: foreign 
shebby: shebby 
italic: italics 
bitch: bitch bitches 
chorus: chorus 
section: section 
ye: ye 
let: let 
drank: drank 
february: february 
anything: anything 
deutsch: deutsch 
subnet: subnet 
good: good 
remixes: remixes 
zero: zero 
merkules: merkules 
released: released 
quarterback: quarterback 
coupe: coupe 
collection: collection 
presidenziale: presidenziale 
insane: insane 
focus: focus 
angel: angel 
dur: dur 
use: use 
wednesday: wednesday 
heard: heard 
lyric: lyrics lyric 
touch: touch touches 
outro: outro 
tint: tint 
ein: ein 
information: information 
rapper: rapper 
maskoffchallenge: maskoffchallenge 
masken: masken 
boy: boy 
soldier: soldier 
certified: certified 
kid: kids kid 
charting: charting 
crazy: crazy 
w: w 
world: world 
holding: holdings 
summermash: summermash 
tony: tony 
rick: rick 
de: de 
oh: oh 
v: v 
massage: massage 
cold: cold 
auguste: auguste 
plate: plates 
manco: manco 
maximus: maximus 
dance: dance 
clowdybluu: clowdybluu 
privacy: privacy 
artist: artists 
yes: yes 
bout: bout 
siimba: siimba 
loved: loved 
go: go 
stabiliti: stabiliti 
carlton: carlton 
funny: funny 
buy: buy 
joyner: joyner 
another: another 
explores: explores 
dont: dont 
humble: humble 
eviri: eviri 
earworm: earworm 
move: move moves 
answer: answer 
jon: jon 
share: share 
classiques: classiques 
devin: devin 
gang: gang 
mysonne: mysonne 
uncle: uncle 
second: second 
never: never 
syrupy: syrupy 
highest: highest 
k: k 
cha: cha 
tilley: tilley 
guideline: guidelines 
check: check 
domain: domain 
song: song songs 
credit: credits 
ferrari: ferrari 
deutsche: deutsche 
tanzania: tanzania 
chill: chills 
rapsdofrancisco: rapsdofrancisco 
man: man 
egreen: egreen 
even: even 
engineer: engineer 
dancing: dancing 
dad: dad 
liar: liar 
huge: huge 
money: money 
el: el 
percocet: percocet 
twist: twist 
songview: songview 
centrozone: centrozone 
nwigwe: nwigwe 
cup: cup cups 
f: fs f 
comment: comment comments 
parlay: parlay 
yungliv: yungliv 
speech: speech 
ocean: ocean 
rep: rep 
contributor: contributor contributors 
squale: squale 
read: read 
meme: memes 
lil: lil 
saske: saske 
savage: savage 
riaa: riaa 
part: parts part 
free: free 
past: past 
header: headers 
champion: champion 
street: street 
snus: snus 
tutweezy: tutweezy 
lorestani: lorestani 
ask: ask 
written: written 
performance: performance 
format: format 
firkin: firkins 
vocalist: vocalists 
lizzo: lizzo 
developer: developers 
reza: reza 
extreme: extremes 
pornovanurid: pornovanurid 
factor: factor 
fm: fm 
ballin: ballin 
flip: flip 
director: director 
alive: alive 
remix: remix 
mohsen: mohsen 
due: due 
pull: pull 
masecha: masecha 
eazer: eazer 
il: il 
rk: rk 
omg: omg 
view: view 
become: become 
injury: injury 
musical: musical 
visit: visit 
tobe: tobe 
fabri: fabri 
created: created 
boomin: boomin 
game: game 
billboard: billboard 
rondor: rondor 
theo: theo 
jam: jam 
pilot: pilot 
ra: ras 
june: june 
ozymandias: ozymandias 
p: p 
play: play 
serf: serves 
fibra: fibra 
chase: chase 
accolade: accolades 
mane: mane 
call: call 
hook: hook 
medium: media 
graduated: graduated 
accomplished: accomplished 
nuori: nuori 
broken: broken 
different: different 
united: united 
babytron: babytron 
fim: fim 
kenli: kenli 
zoom: zoom 
video: videos video 
proof: proof 
casablanca: casablanca 
featured: featured 
flow: flow 
album: album 
trapping: trapping 
prometh: prometh 
tag: tags 
grant: grants 
shutup: shutup 
label: label 
mc: mc 
sapets: sapets 
parody: parody 
started: started 
hol: hol 
ascap: ascap 
producer: producers 
coast: coast 
metro: metro 
walmart: walmart 
trunk: trunks 
type: type 
release: release 
b: b 
prescription: prescriptions 
vaular: vaular 
minecraft: minecraft 
right: rights 
ned: ned 
nav: nav 
group: group 
tommy: tommy 
playing: playing 
demand: demand 
bmi: bmi 
fucked: fucked 
intro: intro 
southside: southside 
dynasty: dynasty 
curren: curren 
x: x 
one: one 
popular: popular 
brown: brown 
transcriber: transcribers 
peaking: peaking 
sweep: sweep 
house: houses 
promethazine: promethazine 
receiving: receiving 
thirty: thirty 
barely: barely 
joshua: joshua 
policy: policy 
publisher: publisher 
future: future 
leaker: leakers 
kendrick: kendrick 
living: living 
draco: draco 
etc: etc 
sell: sell 
tombe: tombe 
adrenaline: adrenaline 
ford: ford 
atlanta: atlanta 
summer: summer 
shot: shots 
luv: luv 
annotation: annotation 
used: used 
air: air 
boobie: boobie 
broke: broke 
toast: toast 
zonin: zonin 
chanel: chanel 
kemo: kemo 
bank: bank 
participant: participants 
along: along 
kaiser: kaiser 
spawned: spawned 
woah: woah 
glace: glace 
later: later 
hippy: hippy 
coming: coming 
genius: genius 
scott: scott 
pede: pede 
scrape: scrape 
sample: samples sample 
featuring: featuring 
people: people 
gry: gry 
press: press 
instantly: instantly 
khaligraph: khaligraph 
milky: milky 
freestyle: freestyle 
rap: rap 
compromisin: compromisin 
sina: sina 
leg: leg 
pt: pt 
mike: mike 
peru: peru 
bersetzungen: bersetzungen 
cruisin: cruisin 
long: long 
pishro: pishro 
major: major 
cem: cem 
gon: gon 
lead: lead 
u: u us 
verified: verified 
n: n 
yee: yee 
rmx: rmx 
g: g 
show: show 
flute: flute flutes 
room: room 
mar: mars 
knowledge: knowledge 
murda: murda 
liives: liives 
georgia: georgia 
groovy: groovy 
jr: jr 
make: make 
talked: talked 
killmenext: killmenext 
siieda: siieda 
west: west 
death: death 
line: lines 
licensing: licensing 
j: j 
pouya: pouya 
life: life 
yo: yo 
tyrone: tyrone 
rich: riches 
th: th 
unge: unge 
theodore: theodore 
sean: sean 
esco: esco 
submarine: submarine 
suchodolski: suchodolski 
promise: promise 
nod: nod 
rebell: rebell 
forum: forum 
hvme: hvme 
lookin: lookin 
rohff: rohff 
molly: molly 
keo: keo 
advertise: advertise 
marvel: marvel 
many: many 
virgin: virgin 
add: add 
rohan: rohan 
teeb: teeb 
freebandz: freebandz 
tec: tec 
percocets: percocets 
trapper: trapper 
medicine: medicine 
understand: understand 
liability: liability 
guide: guide 
josh: josh 
praise: praise 
swear: swear 
catchy: catchy 
break: break 
attendance: attendance 
chain: chains 
moha: moha 
convolk: convolk 
poa: poa 
promote: promote 
av: av 
job: jobs 
hendrix: hendrix 
biggest: biggest 
copyright: copyright 
bold: bold 
isaac: isaac 
bada: bada 
bottom: bottom 
smb: smb 
cover: cover covers 
bankrolluno: bankrolluno 
lucas: lucas 
rest: rest 
contact: contact 
makka: makka 
em: em 
extra: extra 
chained: chained 
state: state states 
biscayne: biscayne 
williams: williams 
ml: ml 
mask: mask 
production: production 
pluto: pluto 
recording: recordings recording 
also: also 
became: became 
slow: slow 
translation: translations 
irving: irving 
goat: goats 
yunk: yunk 
bersetzung: bersetzung 
vega: vegas 
fact: facts 
ce: ce 
beny: beny 
nunca: nunca 
nayvadius: nayvadius 
interview: interviews 
eastmix: eastmix 
ter: ter 
chris: chris 
cancel: cancel 
trap: trap 
range: range 
duke: dukes 
z: z 
singe: singe 
high: high 
come: come 
night: nights 
mistrz: mistrz 
nitro: nitro 
kawasaki: kawasaki 
way: way 
occo: occo 
epic: epic 
top: top 
pulse: pulse 
da: da 
mix: mix 
term: terms 
popularity: popularity 
east: east 
garcia: garcia 
single: singles single 
take: take 
rent: rent 
ytcracker: ytcracker 
lamar: lamar 
lord: lord 
joey: joey 
drifting: drifting 
interpolate: interpolate 
og: og 
james: james 
surface: surface 
la: la 
livin: livin 
dfill: dfill 
embed: embed 
whole: whole 
seller: sellers 
lars: lars 
poppin: poppin 
universal: universal 
ft: ft 
intermission: intermission 
time: time 
ever: ever 
rei: rei 
do: dos 
lih: lih 
galaxy: galaxy 
hot: hot 
three: three 
gas: gas 
kidd: kidd 
since: since 
bkat: bkat 
hrvy: hrvy 
well: well 
ultimate: ultimate 
kulbert: kulbert 
william: william 
marshmello: marshmello 
mirikazizi: mirikazizi 
nother: nother 
super: super 
like: like 
cell: cells 
distinguish: distinguish 
dvoretskov: dvoretskov 
garesk: garesk 
bellinger: bellinger 
million: million 
reserve: reserve 
two: two 
cets: cets 
vient: vient 
mark: mark 
rag: rags 
removed: removed 
battle: battles 
fuck: fuck 
frank: frank 
went: went 
source: source 
fiz: fiz 
sign: sign 
foreigns: foreigns 
mile: miles 
pandemic: pandemic 
half: half 
tre: tre 
davis: davis 
q: q 
pop: pop 
r: r 
guincho: guincho 
colin: colin 
alessandro: alessandro 
country: country 
ronic: ronic 
llc: llc 
official: official 
parliament: parliament 
jswizz: jswizz 
insight: insight 
ya: ya 
e: e 
prison: prison 
studio: studios 
expand: expand 
vino: vino 
big: big 
luxury: luxury 
feel: feel 
stamp: stamps 
toa: toa 
great: great 
dave: dave 
may: may 
repeating: repeating 
grill: grill 
track: track 
overdue: overdue 
love: love 
hit: hit 
ground: ground 
publishing: publishing 
set: set 
guillotine: guillotine 
grc: grc 
soul: soul 
date: date 
food: food 
girl: girls 
platinum: platinum 
rudder: rudder 
c: c 
finny: finny 
op: op 
megamix: megamix 
fast: fast 
plug: plug 
maybach: maybach 
dwoyo: dwoyo 
lens: lenses 
inspired: inspired 
te: tes 
mashup: mashup 
sock: socks 
kesse: kesse 
h: h 
zone: zone 
individual: individual 
exclusive: exclusive 
adaam: adaam 
kamauu: kamauu 
kc: kc 
smoke: smoke 
mission: missions 
eric: eric 
week: weeks 
sampa: sampa 
rob: rob 
personal: personal 
whokilledxix: whokilledxix 
bionicpig: bionicpig 
pink: pink 
transcription: transcription 
chart: charts 
might: might 
butler: butler 
cher: cher 
gone: gone 
universe: universe 
yeah: yeah 
dope: dope 
jones: jones 
dis: diss 
list: list 
spanked: spanked 
pbg: pbg 
fantasma: fantasma 
record: records 
xanahxlic: xanahxlic 
switch: switch 
aspect: aspect 
music: music 
l: l 
bust: bust 
outta: outta 
drive: drive 
business: business 
boostin: boostin 
travis: travis 
question: question 
war: war 
instrument: instruments 
fed: feds 
drop: drop 
gotta: gotta 
shop: shop 
produced: produced 
neet: neet 
learn: learn 
remy: remy 
lootaveli: lootaveli 
spit: spit 
miky: miky 
car: car 
verse: verse 
woodz: woodz 
young: young 
recorded: recorded 
royce: royce 
ta: ta 
wildad: wildad 
dj: dj 
leilan: leilan 
coeur: coeur 
scholar: scholars 
initially: initially 
fo: fo 
shiloh: shiloh 
beam: beams 
story: story 
fuckin: fuckin 
emperor: emperor 
drug: drug 
seth: seth 
version: version 
otm: otm 
soir: soir 
calamari: calamari 
karen: karen 
jay: jay 
beat: beat 
envidi: envidi 
moni: moni 
