double: double 
slop: slop 
tradu: tradu 
chylow: chylow 
jackhoeting: jackhoeting 
famous: famous 
italic: italics 
woo: woo 
bitch: bitch bitches 
term: term terms 
gomringer: gomringer 
chorus: chorus 
stacey: stacey 
still: still 
section: section 
mo: mo 
time: times time 
gamechops: gamechops 
ant: ant 
let: let 
pr: prs 
pas: pass 
suit: suit 
kevin: kevin 
jumpin: jumpin 
semi: semi 
deutsch: deutsch 
remixes: remixes 
cyhi: cyhi 
dawgs: dawgs 
mark: marks 
mi: mi 
toronto: toronto 
koch: koch 
stripe: stripes 
kyle: kyle 
tanta: tanta 
traductions: traductions 
rez: rez 
collection: collection 
insane: insane 
unpatched: unpatched 
sellin: sellin 
colored: colored 
parachute: parachute 
nitin: nitin 
use: use 
dub: dub 
lodat: lodat 
corp: corp 
lyric: lyrics lyric 
matxeus: matxeus 
bad: bad 
give: give 
deep: deep 
tint: tint 
stop: stop 
doo: doo 
put: put 
vito: vito 
information: information 
rapper: rapper 
demo: demo 
baguette: baguettes 
boy: boy boys 
wellz: wellz 
redan: redan 
tip: tip 
facetime: facetime 
cubeatz: cubeatz 
portland: portland 
hype: hype 
vanityz: vanityz 
azerrz: azerrz 
w: w 
eleck: eleck 
scherrer: scherrer 
world: world 
holding: holdings 
making: making 
traduction: traduction 
goin: goin 
oh: oh 
gale: gale 
slider: slider 
v: v 
baby: baby 
third: third 
cold: cold 
codeine: codeine 
back: back 
bootch: bootch 
tomi: tomi 
wanna: wanna 
hand: hands 
seeza: seeza 
lex: lex 
wake: wake 
fortnite: fortnite 
prod: prod 
dance: dance 
concord: concord 
duck: duck 
nathan: nathan 
acrylo: acrylo 
privacy: privacy 
artist: artists artist 
lecca: lecca 
ayy: ayy 
nj: nj 
settle: settle 
nonstop: nonstop 
bout: bout 
carter: carter 
go: go 
sunset: sunset 
ca: ca 
juice: juice 
cracker: crackers 
ubem: ubem 
dick: dick 
consey: consey 
eviri: eviri 
ice: ice 
earworm: earworm 
session: sessions 
answer: answer 
sickamore: sickamore 
jon: jon 
share: share 
roll: roll 
bedroom: bedroom 
harmony: harmony 
spoofer: spoofer 
uncle: uncle 
feat: feat 
never: never 
far: far 
k: k 
tim: tim 
impression: impressions 
think: think 
voice: voice 
dcn: dcn 
guideline: guidelines 
pizza: pizza 
check: check checks 
song: song songs 
credit: credits 
stinko: stinko 
impel: impel 
houstonfornication: houstonfornication 
megamashup: megamashup 
bickle: bickle 
showing: showing 
deutsche: deutsche 
bein: bein 
wag: wag 
emulation: emulation 
love: loves love 
wayne: wayne 
man: man 
formal: formal 
going: going 
crankdat: crankdat 
mashups: mashups 
block: block blocks 
even: even 
awkward: awkward 
sybyr: sybyr 
engineer: engineer 
aerozen: aerozen 
jelly: jelly 
post: post 
casey: casey 
fat: fat 
winter: winter 
marijuana: marijuana 
whethan: whethan 
arthur: arthur 
huge: huge 
function: function 
ii: ii 
songview: songview 
shandhokhan: shandhokhan 
comment: comment comments 
hometown: hometown 
band: band 
ocean: ocean 
book: book 
contributor: contributor contributors 
yung: yung 
citron: citron 
hi: hi 
elo: elo 
read: read 
sofus: sofus 
mother: mother 
meme: memes meme 
lil: lil 
english: english 
riaa: riaa 
part: parts part 
free: free 
past: past 
header: headers 
right: right rights 
next: next 
almo: almo 
jeweler: jeweler 
jack: jack 
circle: circle 
ask: ask 
written: written 
performance: performance performances 
sickomod: sickomod 
format: format 
vocalist: vocalists 
workin: workin 
south: south 
developer: developers 
quise: quise 
town: town 
outside: outside 
wetty: wetty 
probably: probably 
road: road 
knocked: knocked 
cactus: cactus 
astronomical: astronomical 
struggle: struggles 
krist: krist 
wes: wes 
collaboration: collaboration 
bmg: bmg 
screw: screw 
sucko: sucko 
phonographic: phonographic 
director: director 
peppa: peppa 
remix: remix 
pull: pull 
kutyah: kutyah 
duffel: duffels 
shaheed: shaheed 
rk: rk 
pearl: pearl 
muzik: muzik 
mixing: mixing 
sedano: sedano 
wrld: wrld 
view: view 
theman: theman 
natey: natey 
musical: musical 
visit: visit 
kam: kam 
cockaholics: cockaholics 
harry: harry 
billboard: billboard 
shit: shit 
rondor: rondor 
boomin: boomin 
created: created 
clue: clue 
trump: trump 
p: p 
head: head 
xxxtentacion: xxxtentacion 
muhammad: muhammad 
play: play 
marf: marf 
see: see 
keith: keith 
japan: japan 
uh: uh 
spinnin: spinnin 
oscar: oscar 
chase: chase 
dizzy: dizzy 
dash: dash 
gifted: gifted 
medium: media 
surfo: surfo 
threat: threat 
broken: broken 
different: different 
united: united 
shot: shot shots 
vida: vida 
bright: bright 
star: star 
hour: hours hour 
rock: rock 
e: es e 
video: videos video 
pussy: pussy 
win: win 
casablanca: casablanca 
featured: featured 
light: light lights 
shorty: shorty 
tag: tags 
nothin: nothin 
grant: grants 
scp: scp 
label: label 
mc: mc 
parody: parody 
astro: astro 
pat: pat 
sistergalactic: sistergalactic 
ballad: ballad 
ascap: ascap 
al: al 
collaborate: collaborate 
got: got 
otsochodzi: otsochodzi 
reboot: reboot 
tryna: tryna 
coast: coast 
oven: oven 
metro: metro 
clean: clean 
lock: lock 
type: type 
george: george 
mosquito: mosquito 
release: release 
b: b 
footye: footye 
mol: mols 
con: con 
pluffaduff: pluffaduff 
mp: mp 
barrel: barrel 
prolly: prolly 
group: group 
jump: jump 
would: would 
quavo: quavo 
bmi: bmi 
papa: papa 
together: together 
trippie: trippie 
mining: mining 
intro: intro 
french: french 
inc: inc 
adriansings: adriansings 
randhawa: randhawa 
north: north 
nc: nc 
x: x 
one: one 
carousel: carousel 
brown: brown 
transcriber: transcribers 
contribution: contribution 
facetimed: facetimed 
night: night 
green: green 
harbor: harbor 
elevate: elevate 
durant: durant 
deleted: deleted 
siivagunner: siivagunner 
sxnned: sxnned 
jamba: jamba 
roof: roof 
crank: crank 
myke: myke 
class: class 
pedro: pedro 
policy: policy 
gayhiphop: gayhiphop 
slept: slept 
publisher: publisher 
competition: competition 
lakeith: lakeith 
marton: marton 
hoppin: hoppin 
tamerlane: tamerlane 
papoose: papoose 
slim: slim 
etc: etc 
sell: sell 
friend: friends 
blackman: blackman 
fran: fran 
took: took 
arcade: arcade 
portugu: portugu 
texas: texas 
tiko: tiko 
loose: loose 
gxx: gxx 
anthem: anthem 
roba: roba 
edit: edit 
used: used 
annotation: annotation 
perform: perform 
over: overs 
hardy: hardy 
chokin: chokin 
company: company 
fiasco: fiasco 
life: lives 
daymanoursavior: daymanoursavior 
experimental: experimental 
nigga: niggas 
instagram: instagram 
jazz: jazz 
reptilelegityt: reptilelegityt 
ben: ben 
push: push 
ttelse: ttelse 
told: told 
cabriolet: cabriolet 
glute: glutes 
coupe: coupes 
genius: genius 
iv: iv 
vernacular: vernacular 
scott: scott 
flight: flight 
amra: amra 
lost: lost 
astrothunder: astrothunder 
sample: samples sample 
featuring: featuring 
blue: blue 
press: press 
cut: cut 
yun: yun 
russian: russian 
su: su 
performed: performed 
freestyle: freestyle 
hippo: hippo 
vmas: vmas 
latte: latte 
luc: luc 
rap: rap 
blake: blake 
retreat: retreat 
bengineer: bengineer 
mike: mike 
jonny: jonny 
md: md 
uicideboy: uicideboy 
bersetzungen: bersetzungen 
long: long 
emma: emma 
ninja: ninja 
else: else 
meyers: meyers 
forever: forever 
thorlyfe: thorlyfe 
u: u us 
ear: ear 
overspace: overspace 
mama: mama 
verified: verified 
n: n 
landed: landed 
pearce: pearce 
number: number 
freezin: freezin 
rmx: rmx 
posse: posse 
g: g 
koms: koms 
ziah: ziah 
teamed: teamed 
show: show 
pasquale: pasquale 
room: room 
forbes: forbes 
charged: charged 
knowledge: knowledge 
absolute: absolute 
fruit: fruits 
tay: tay 
make: make 
lizzie: lizzie 
sign: signs sign 
death: death 
zaia: zaia 
tea: tea 
line: lines 
dicko: dicko 
licensing: licensing 
kushmit: kushmit 
obladaet: obladaet 
brasil: brasil 
danny: danny 
j: j 
assistant: assistant 
sony: sony 
yo: yo 
noose: noose 
gimme: gimme 
someone: someone 
sean: sean 
kite: kites 
submarine: submarine 
pool: pool 
golden: golden 
escopablo: escopablo 
peach: peach 
say: say 
thirteen: thirteen 
pablo: pablo 
ol: ol 
akinola: akinola 
pher: pher 
aw: aw 
forum: forum 
late: late 
atolofficial: atolofficial 
quentin: quentin 
traducciones: traducciones 
aim: aim 
said: said 
ffm: ffm 
advertise: advertise 
exum: exum 
ai: aises ais 
many: many 
dawg: dawg 
additional: additional 
campa: campa 
malone: malone 
saying: saying 
add: add 
crew: crew 
hpassion: hpassion 
august: august 
germ: germ 
dean: dean 
cosmic: cosmic 
crept: crept 
understand: understand 
guide: guide 
extreme: extreme 
wet: wet 
hotmess: hotmess 
praise: praise 
cheek: cheek 
belt: belt 
sight: sight 
goose: goose 
astroworld: astroworld 
chain: chains 
ab: ab 
soda: soda 
limelight: limelight 
handsome: handsome 
fobobular: fobobular 
bruhmanegod: bruhmanegod 
blood: blood 
school: school 
project: projects 
ferbinho: ferbinho 
poppa: poppa 
promote: promote 
hip: hip 
comb: combs 
sonny: sonny 
sweet: sweet 
kobalt: kobalt 
lando: lando 
handbrajeans: handbrajeans 
price: price 
pyscho: pyscho 
foot: foot foots 
wish: wish 
melody: melody 
copyright: copyright 
skrillex: skrillex 
biggest: biggest 
job: jobs 
bold: bold 
hill: hill 
hack: hacks 
doodle: doodle 
stomp: stomp 
valley: valley 
plan: plan 
f: f 
leggexd: leggexd 
old: old 
cover: cover covers 
sicko: sicko 
lucas: lucas 
wellhellothere: wellhellothere 
chappell: chappell 
contact: contact 
teased: teased 
eliano: eliano 
em: em 
turkish: turkish 
state: state 
chahayed: chahayed 
casa: casa 
peaceful: peaceful 
pandora: pandora 
serious: serious 
cauzione: cauzione 
ml: ml 
brought: brought 
bambo: bambo 
mask: mask 
jvn: jvn 
es: eses 
production: production 
also: also 
distributor: distributor 
get: get 
wall: wall 
management: management 
notorious: notorious 
effect: effect 
laferrari: laferrari 
translation: translations translation 
traducci: traducci 
jesus: jesus 
paid: paid 
lockdown: lockdown 
boi: boi 
bersetzung: bersetzung 
vuitton: vuitton 
sher: sher 
lit: lit 
score: scores 
asap: asap 
comin: comin 
fact: facts 
fbo: fbo 
keep: keeps keep 
oof: oof 
reading: reading 
bamba: bamba 
low: low 
cancel: cancel 
reaction: reaction 
dirty: dirty 
longitude: longitude 
trap: trap 
z: z 
tweeted: tweeted 
high: high 
solar: solar 
everman: everman 
mode: mode 
turn: turn 
nice: nice 
mastering: mastering 
way: way 
emi: emi 
cream: cream 
new: new 
rog: rog 
look: look 
solymar: solymar 
santana: santana 
vincent: vincent 
deadify: deadify 
made: made 
orchestra: orchestra 
lupe: lupe 
epic: epic 
top: top 
nah: nah 
passed: passed 
pulse: pulse 
ali: ali 
polaris: polaris 
cliff: cliffs 
valence: valence 
booth: booth 
xan: xan 
celly: celly 
thought: thought 
east: east 
gunplay: gunplay 
refers: refers 
hoe: hoes 
take: take 
open: open 
joey: joey 
interpolate: interpolate 
exile: exile 
whopper: whopper 
latinautor: latinautor 
sheck: sheck 
drummer: drummers 
god: god 
moneybagg: moneybagg 
grand: grand 
teach: teach 
hop: hop 
james: james 
la: la 
matoosh: matoosh 
gru: gru 
trying: trying 
jetez: jetez 
embed: embed 
disease: disease 
aise: aise 
vald: vald 
first: first 
glizzy: glizzy 
poppin: poppin 
hustle: hustle 
beast: beast 
kray: kray 
tried: tried 
replied: replied 
universal: universal 
ft: ft 
ever: ever 
veleno: veleno 
digital: digital 
mix: mixes 
sun: sun 
collaborated: collaborated 
blockhampton: blockhampton 
hot: hot 
radio: radio 
three: three 
nike: nike 
ultimate: ultimate 
refrain: refrain 
fourth: fourth 
like: like 
super: super 
distinguish: distinguish 
guy: guy 
bellinger: bellinger 
collective: collective 
two: two 
bean: bean 
parker: parker 
gate: gate 
stargazing: stargazing 
cmrra: cmrra 
treat: treat 
follow: follow 
crack: crack 
refix: refix 
fuck: fuck 
chillinit: chillinit 
tower: towers 
beatz: beatz 
uk: uk 
shook: shook 
source: source 
need: need 
laying: laying 
justin: justin 
hawk: hawk 
q: q 
half: half 
legacy: legacy 
matt: matt 
unknown: unknown 
flyingkitty: flyingkitty 
pop: pop 
r: r 
broder: broder 
survival: survival 
gims: gims 
awakens: awakens 
redd: redd 
jj: jj 
industry: industry 
swae: swae 
spanish: spanish 
louis: louis 
sandra: sandra 
llc: llc 
gemitaiz: gemitaiz 
il: il 
insight: insight 
chainz: chainz 
daughter: daughter 
expand: expand 
adam: adam 
big: big 
hell: hell 
loot: loot 
coffee: coffee 
recording: recording 
april: april 
apoc: apoc 
stife: stife 
christopher: christopher 
fetish: fetish 
portuguese: portuguese 
pa: pas 
already: already 
dave: dave 
selc: selc 
repeating: repeating 
luke: luke 
track: track 
overdue: overdue 
warrior: warriors 
til: til 
hit: hit 
peermusic: peermusic 
raulondabeat: raulondabeat 
sendin: sendin 
publishing: publishing 
work: work 
ex: exes 
iii: iii 
dansk: dansk 
sam: sam 
baldo: baldo 
sakooni: sakooni 
ne: ne 
miller: miller 
date: date 
food: food 
girl: girls 
skrrt: skrrt 
platinum: platinum 
glue: glue 
c: c 
text: texts 
megamix: megamix 
fast: fast 
capoxxo: capoxxo 
swaivey: swaivey 
starbus: starbus 
oz: oz 
martin: martin 
logic: logic 
dog: dog 
frakk: frakk 
mashup: mashup 
weak: weak 
ziegler: ziegler 
h: h 
individual: individual 
shhh: shhh 
stackonit: stackonit 
land: land 
certification: certifications 
respect: respect 
tractor: tractor 
playin: playin 
shoot: shoot 
derived: derived 
four: four 
eric: eric 
billy: billy 
hail: hail 
know: know 
solo: solo 
rob: rob 
personal: personal 
merchant: merchant 
transcription: transcription 
chart: charts 
might: might 
pedl: pedl 
icko: icko 
yosemite: yosemite 
montythehokage: montythehokage 
yeah: yeah 
bus: bus 
turnin: turnin 
dude: dude 
toasty: toasty 
pick: pick 
dis: diss 
mr: mr 
canadiana: canadiana 
mint: mint 
christ: christ 
socan: socan 
warner: warner 
vocal: vocals 
bonnaroo: bonnaroo 
bicko: bicko 
bit: bit 
record: records 
ppl: ppl 
switch: switch 
urbanist: urbanist 
lama: lama 
music: music 
l: l 
really: really 
butterfly: butterfly 
fake: fakes 
news: news 
lee: lee 
global: global 
live: live 
drive: drive 
moon: moon 
br: br 
ethic: ethic 
travis: travis 
kony: kony 
question: question 
mafia: mafia 
producer: producer 
dex: dex 
drop: drop 
lixo: lixo 
shop: shop 
espa: espa 
shapo: shapo 
produced: produced 
learn: learn 
remy: remy 
king: king 
connor: connor 
move: moves 
bystander: bystanders 
referring: referring 
car: car 
flame: flame 
verse: verse 
happened: happened 
imagined: imagined 
young: young 
skeleton: skeletons 
panini: panini 
dj: dj 
scholar: scholars 
drake: drake 
hub: hub 
seen: seen 
viva: viva 
legit: legit 
interpolation: interpolations 
amico: amico 
ghela: ghela 
aresa: aresa 
seth: seth 
malves: malves 
version: version 
scary: scary 
entertainment: entertainment 
owo: owo 
danish: danish 
audio: audio 
beat: beat 
ill: ill 
atv: atv 
africa: africa 
abramus: abramus 
special: special 
