koen: koen 
tradu: tradu 
jackhoeting: jackhoeting 
italic: italics 
around: around 
chorus: chorus 
section: section 
mo: mo 
time: times time 
girl: girl girls 
nederlandse: nederlandse 
found: found 
let: let 
throughout: throughout 
kevin: kevin 
vers: vers 
operator: operators 
deutsch: deutsch 
hate: hate 
imanbek: imanbek 
remixes: remixes 
rituvl: rituvl 
weep: weep 
wasted: wasted 
traductions: traductions 
collection: collection 
llj: llj 
use: use 
goodbye: goodbye 
svenska: svenska 
latinautorperf: latinautorperf 
grip: grip 
lyric: lyrics lyric 
bad: bad 
razorback: razorback 
ttning: ttning 
suicide: suicide 
julian: julian 
information: information 
rapper: rapper 
tear: tears 
boy: boy 
faik: faik 
soldier: soldier 
w: w 
world: world 
holding: holdings 
otw: otw 
making: making 
traduction: traduction 
koziel: koziel 
letting: letting 
reaper: reaper 
v: v vs 
platform: platform 
guyzzz: guyzzz 
baby: baby 
fouine: fouine 
try: try 
vertaling: vertaling 
sky: sky 
back: back 
alex: alex 
frequently: frequently 
fox: fox 
kurt: kurt 
rbaycan: rbaycan 
gomes: gomes 
hater: haters 
privacy: privacy 
hope: hope 
artist: artists artist 
yes: yes 
geekheavy: geekheavy 
russell: russell 
rap: raps rap 
smr: smr 
carter: carter 
loved: loved 
go: go 
another: another 
noy: noy 
villain: villain 
juice: juice 
eviri: eviri 
answer: answer 
eliot: eliot 
share: share 
kooda: kooda 
beautiful: beautiful 
feat: feat 
rip: rip 
leebrian: leebrian 
wg: wg 
k: k 
tim: tim 
think: think 
voice: voice voices 
suomenkielinen: suomenkielinen 
guideline: guidelines 
check: check 
skye: skye 
song: song songs 
itsamoney: itsamoney 
credit: credits 
cheese: cheese 
hebrew: hebrew 
arkwea: arkwea 
deutsche: deutsche 
bein: bein 
insecure: insecure 
cole: cole 
melancholy: melancholy 
gonna: gonna 
colombia: colombia 
smokepurpp: smokepurpp 
going: going 
even: even 
engineer: engineer 
ina: ina 
instrumental: instrumental 
happy: happy 
drowzee: drowzee 
bailey: bailey 
camera: camera 
rich: rich 
fillmyveinswithpoison: fillmyveinswithpoison 
liar: liar 
santiago: santiago 
prisayanh: prisayanh 
everything: everything 
money: money 
ii: ii 
songview: songview 
comment: comment comments 
example: example 
bestfriend: bestfriend 
contributor: contributor contributors 
yung: yung 
read: read 
xxx: xxx 
lil: lil 
riaa: riaa 
part: parts part 
free: free 
past: past 
header: headers 
lukas: lukas 
ask: ask 
written: written 
remedy: remedy 
sloven: sloven 
performance: performance 
format: format 
so: sos 
vocalist: vocalists 
westwood: westwood 
developer: developers 
jango: jango 
clonnex: clonnex 
rbaycanca: rbaycanca 
bridge: bridge bridges 
problem: problems 
curtaine: curtaine 
joel: joel 
decide: decide 
adem: adem 
emo: emo 
triste: triste 
john: john 
phonographic: phonographic 
director: director 
remix: remix 
due: due 
eventually: eventually 
wrld: wrld 
rk: rk 
mixing: mixing 
view: view 
musical: musical 
visit: visit 
oceanboytrea: oceanboytrea 
steven: steven 
belong: belong 
created: created 
billboard: billboard 
june: june 
p: p 
xxxtentacion: xxxtentacion 
play: play 
killed: killed 
schneider: schneider 
uh: uh 
kool: kool 
rauf: rauf 
eternity: eternity 
broken: broken 
different: different 
unrest: unrest 
stunt: stunt 
czech: czech 
clique: clique 
arg: arg 
swift: swift 
shot: shot 
bright: bright 
sktl: sktl 
shinra: shinra 
jared: jared 
rock: rock 
gurrin: gurrin 
e: es e 
video: videos video 
featured: featured 
murat: murat 
album: album 
taylor: taylor 
vibe: vibes vibe 
elio: elio 
ukhohliwe: ukhohliwe 
tag: tags 
label: label 
evan: evan 
grant: grants 
parody: parody 
keyboard: keyboards 
ascap: ascap 
emotion: emotions 
memory: memories 
paredes: paredes 
al: al 
key: key 
scienceos: scienceos 
type: type 
release: release 
b: b 
fawke: fawke 
pane: pane 
minecraft: minecraft 
gaffer: gaffer 
right: rights 
swervex: swervex 
group: group 
zeno: zeno 
together: together 
intro: intro 
french: french 
stream: streams 
posthumously: posthumously 
svensk: svensk 
jiorgi: jiorgi 
x: x 
one: one 
brown: brown 
transcriber: transcribers 
following: following 
cumbagg: cumbagg 
prior: prior 
colorist: colorist 
rasster: rasster 
luvplxto: luvplxto 
crank: crank 
lofi: lofi 
policy: policy 
publisher: publisher 
mendez: mendez 
theonlylilhomie: theonlylilhomie 
production: productions production 
lonely: lonely 
alternative: alternative 
etc: etc 
sell: sell 
fran: fran 
took: took 
portugu: portugu 
garlyn: garlyn 
az: az 
lovely: lovely 
annotation: annotation 
listen: listen 
wonder: wonder 
saddest: saddest 
szela: szela 
broke: broke 
company: company 
graham: graham 
diaz: diaz 
pm: pm 
polish: polish 
debuted: debuted 
schizophrenia: schizophrenia 
best: best 
blacc: blacc 
witness: witness 
push: push 
reptilelegityt: reptilelegityt 
slovensk: slovensk 
tune: tune 
genius: genius 
amra: amra 
lost: lost 
nino: nino 
sample: samples sample 
anymore: anymore 
animal: animals 
blue: blue 
jumped: jumped 
press: press 
russian: russian 
afrojack: afrojack 
freestyle: freestyle 
sound: sound 
wunderworld: wunderworld 
cunningham: cunningham 
pt: pt 
mike: mike 
bersetzungen: bersetzungen 
programmer: programmer 
asapolis: asapolis 
associate: associate 
follows: follows 
forever: forever 
jahseh: jahseh 
farm: farm 
u: u us 
verified: verified 
n: n 
hearns: hearns 
jehl: jehl 
rmx: rmx 
heartbroken: heartbroken 
g: g 
ciggy: ciggy 
cxldwrld: cxldwrld 
afraid: afraid 
ksi: ksi 
left: left 
misty: misty 
feid: feid 
every: every 
knowledge: knowledge 
marie: marie 
suffered: suffered 
available: available 
cletus: cletus 
untitled: untitled 
novelist: novelist 
death: death 
line: lines 
brasil: brasil 
licensing: licensing 
peterson: peterson 
j: j 
assistant: assistant 
german: german 
heldens: heldens 
kermit: kermit 
someone: someone 
finnish: finnish 
chart: chart charts 
problemen: problemen 
italiane: italiane 
nederland: nederlands 
iam: iam 
vertalingen: vertalingen 
cunninghamburger: cunninghamburger 
jmp: jmp 
ol: ol 
ddity: ddity 
forum: forum 
tonight: tonight 
traducciones: traducciones 
nn: nn 
espuma: espuma 
mad: mad 
almighty: almighty 
advertise: advertise 
ai: aises ais 
editor: editor 
campa: campa 
add: add 
garnered: garnered 
specific: specific 
swedish: swedish 
fact: fact facts 
understand: understand 
florida: florida 
rather: rather 
guide: guide 
shrezzers: shrezzers 
traduzione: traduzione 
kingxii: kingxii 
closed: closed 
rose: rose 
ugly: ugly 
promote: promote 
kobalt: kobalt 
copyright: copyright 
job: jobs 
biggest: biggest 
joss: joss 
bold: bold 
trip: trip 
spotify: spotify 
numb: numb 
wee: wee 
f: f 
photography: photography 
umaczenie: umaczenie 
cover: cover covers 
lucas: lucas 
contact: contact 
teased: teased 
girlfriend: girlfriend 
tho: tho 
em: em 
turkish: turkish 
uncertainty: uncertainty 
jocelyn: jocelyn 
bringing: bringing 
ml: ml 
marzbarz: marzbarz 
alone: alone 
also: also 
distributor: distributor 
eye: eyes 
angemi: angemi 
umaczenia: umaczenia 
played: played 
polski: polski 
slovak: slovak 
notorious: notorious 
translation: translations translation 
brill: brill 
traducci: traducci 
friend: friend 
goat: goats 
close: close 
didnt: didnt 
bersetzung: bersetzung 
white: white 
dmmix: dmmix 
dutch: dutch 
interlude: interlude 
tribute: tribute 
garnering: garnering 
paranoia: paranoia 
contagious: contagious 
youtube: youtube 
cancel: cancel 
squint: squint 
trap: trap 
z: z 
record: record records 
brings: brings 
lwnluwin: lwnluwin 
mastering: mastering 
depression: depression 
look: look 
capitol: capitol 
brandon: brandon 
deadify: deadify 
made: made 
top: top 
da: da 
term: terms 
gaming: gaming 
streaming: streaming 
polskie: polskie 
passing: passing 
original: original 
wolter: wolter 
channel: channel 
joey: joey 
interpolate: interpolate 
discography: discography 
smash: smash 
latinautor: latinautor 
clarence: clarence 
dvrklxght: dvrklxght 
emberville: emberville 
james: james 
la: la 
aise: aise 
embed: embed 
anne: anne 
kmr: kmr 
first: first 
instruction: instructions 
luckhaos: luckhaos 
universal: universal 
ft: ft 
ever: ever 
digital: digital 
kenny: kenny 
wait: wait 
galaxy: galaxy 
main: main 
fame: fame 
hot: hot 
kidd: kidd 
since: since 
current: current 
graphic: graphics 
ultimate: ultimate 
pee: pee 
vitamin: vitamin 
string: string 
virus: virus 
like: like 
distinguish: distinguish 
million: million 
suomi: suomi 
jenn: jenn 
mark: mark 
preklad: preklad 
kanye: kanye 
dababy: dababy 
tensei: tensei 
source: source 
theep: theep 
leave: leave 
need: need 
sign: sign 
q: q 
gave: gave 
davis: davis 
day: day 
pop: pop 
r: r 
andthisisdeep: andthisisdeep 
quartet: quartet 
rl: rl 
minute: minutes 
spanish: spanish 
dia: dia 
llc: llc 
royalty: royalties 
bantling: bantling 
dry: dry 
insight: insight 
studio: studios 
blumbo: blumbo 
ray: ray 
expand: expand 
cry: crying 
sad: sad 
horizonte: horizonte 
recording: recording 
pain: pain 
christopher: christopher 
johnson: johnson 
portuguese: portuguese 
dave: dave 
held: held 
pyeatt: pyeatt 
repeating: repeating 
dark: dark 
discussed: discussed 
track: track 
change: changes 
rc: rc 
love: love 
hit: hit 
kaws: kaws 
autisles: autisles 
ily: ily 
detail: details 
jrkellyrocks: jrkellyrocks 
set: set 
azerbaijani: azerbaijani 
soul: soul 
dated: dated 
date: date 
floor: floor 
lament: laments 
c: c 
hugo: hugo 
relationship: relationship 
xo: xo 
kutch: kutch 
march: march 
dillon: dillon 
daniel: daniel 
kingsolrac: kingsolrac 
burning: burning 
bunnie: bunnie 
mashup: mashup 
flores: flores 
torture: torture 
h: h 
individual: individual 
hitchcock: hitchcock 
bryce: bryce 
scsp: scsp 
mistake: mistakes 
certification: certifications 
fix: fix 
previous: previous 
crown: crown 
know: know 
coordinator: coordinator 
heart: heart 
kevdog: kevdog 
norton: norton 
personal: personal 
prunt: prunt 
saaf: saaf 
transcription: transcription 
might: might 
franssen: franssen 
subject: subject 
yeah: yeah 
idea: idea 
aiono: aiono 
lochlainn: lochlainn 
brother: brother 
sing: sing 
italian: italian 
music: music 
l: l 
surrounding: surrounding 
struggle: struggle 
queen: queen 
kid: kid 
br: br 
travis: travis 
dyscaine: dyscaine 
question: question 
producer: producer 
chico: chico 
treeshy: treeshy 
speak: speak 
drop: drop 
lixo: lixo 
octobersfullmoon: octobersfullmoon 
txriq: txriq 
introduction: introduction 
feeling: feeling 
espa: espa 
produced: produced 
shop: shop 
learn: learn 
habitanto: habitanto 
savze: savze 
motion: motion 
mik: mik 
often: often 
wanted: wanted 
verse: verse 
young: young 
rooie: rooie 
recorded: recorded 
mob: mobs 
halation: halation 
italiana: italiana 
dj: dj 
blessed: blessed 
prince: prince 
scholar: scholars 
tristan: tristan 
fire: fire 
lol: lol 
slight: slight 
fuckin: fuckin 
interpolation: interpolations 
infinity: infinity 
par: par 
download: download 
version: version 
sc: sc 
memo: memo 
traduzioni: traduzioni 
jcb: jcb 
jay: jay 
italiano: italiano 
moonlight: moonlight 
