atlantic: atlantic 
dominicana: dominicana 
celia: celia 
italic: italics 
bitch: bitch bitches 
woo: woo 
isosine: isosine 
chorus: chorus 
dieta: dieta 
section: section 
iglesias: iglesias 
jalan: jalan 
like: likes like 
rrrah: rrrah 
deutsch: deutsch 
gustan: gustan 
remixes: remixes 
modelo: modelo 
andrew: andrew 
mi: mi mis 
te: te 
crk: crk 
eating: eating 
released: released 
traductions: traductions 
coupe: coupe 
leonard: leonard 
collection: collection 
craig: craig 
tell: tell 
use: use 
emme: emme 
mente: mente 
juan: juan 
lyric: lyrics lyric 
bad: bad 
snuka: snuka 
nia: nia 
perico: perico 
richie: richie 
invincible: invincible 
maddie: maddie 
put: put 
information: information 
rapper: rapper rappers 
boy: boy 
topped: topped 
hype: hype 
certified: certified 
ksr: ksr 
jordan: jordan 
kid: kids 
azerrz: azerrz 
charting: charting 
w: w 
world: world 
holding: holdings 
rewind: rewind 
concert: concert 
tony: tony 
de: de 
traduction: traduction 
diamond: diamond diamonds 
oh: oh 
v: v 
twice: twice 
baby: baby 
benevides: benevides 
see: sees 
lam: lam 
wuh: wuh 
bunny: bunny 
abraza: abraza 
cardi: cardi 
testarossa: testarossa 
teacher: teachers 
much: much 
kurt: kurt 
balenciaga: balenciagas balenciaga 
banging: banging 
beb: beb 
privacy: privacy 
artist: artists artist 
want: want 
buh: buh 
framework: framework 
jeva: jeva 
underpinned: underpinned 
nonstop: nonstop 
bout: bout 
marking: marking 
loved: loved 
andamos: andamos 
tumbar: tumbar 
rico: rico 
ca: ca 
fonic: fonic 
trevor: trevor 
run: run 
muchdank: muchdank 
hotter: hotter 
kidz: kidz 
answer: answer 
valent: valent 
earworm: earworm 
share: share 
groove: grooves 
gang: gang 
spend: spend 
paparazzo: paparazzi 
second: second 
mot: mot 
week: week weeks 
chambea: chambea 
cardio: cardio 
k: k 
eh: eh 
cha: cha 
mcchicken: mcchicken 
impression: impressions 
co: co 
edgar: edgar 
voice: voice 
guideline: guidelines 
name: name 
check: check 
rican: rican 
song: song songs 
credit: credits 
ferrari: ferrari 
eddie: eddie 
horn: horn 
deutsche: deutsche 
darrale: darrale 
coin: coins 
colombia: colombia 
latin: latin 
escuchado: escuchado 
going: going 
feature: features 
rrr: rrr 
blackwood: blackwood 
even: even 
engineer: engineer 
ni: ni 
instrumental: instrumental 
post: post 
celebrity: celebrities 
puerto: puerto 
retumbe: retumbe 
fat: fat 
liar: liar 
llama: llama 
pomarico: pomarico 
el: el 
soy: soy 
comment: comment comments 
mucha: mucha 
coat: coat 
le: les 
bodak: bodak 
contributor: contributor contributors 
mud: mud 
district: district 
boogaloo: boogaloo 
read: read 
lil: lil 
correia: correia 
english: english 
part: parts part 
ranked: ranked 
background: background 
header: headers 
champion: champion 
sufre: sufre 
jeweler: jeweler 
ask: ask 
performance: performance performances 
written: written 
proving: proving 
longest: longest 
format: format 
vocalist: vocalists 
pasar: pasar 
ah: ah 
developer: developers 
bridge: bridge 
july: july 
joel: joel 
bmg: bmg 
phonographic: phonographic 
director: director 
remix: remix 
atas: atas 
xavier: xavier 
mixing: mixing 
chingan: chingan 
view: view 
musical: musical 
que: que 
visit: visit 
though: though 
spicy: spicy 
created: created 
billboard: billboard 
shit: shit 
vive: vive 
p: p 
schneider: schneider 
uh: uh 
toca: toca 
accolade: accolades 
aqu: aqu 
pa: pa 
allegro: allegro 
call: call 
gabriel: gabriel 
broken: broken 
different: different 
lo: lo 
united: united 
cara: cara 
pardison: pardison 
vida: vida 
star: star 
fontaine: fontaine 
e: es e 
video: videos video 
featured: featured 
tag: tags 
label: label 
remained: remained 
trumpet: trumpet 
ballad: ballad 
kontra: kontra 
ascap: ascap 
al: al 
forma: forma 
tamale: tamale 
type: type 
llego: llego 
b: b 
release: release 
barack: barack 
grasa: grasa 
efu: efu 
right: rights 
joe: joe 
cosa: cosa 
jump: jump 
quieras: quieras 
group: group 
bmi: bmi 
hagas: hagas 
intro: intro 
ozuna: ozuna 
french: french 
gusta: gusta 
gheboas: gheboas 
x: x 
one: one ones 
transcriber: transcribers 
following: following 
getinjo: getinjo 
lardi: lardi 
chambean: chambean 
ti: ti 
billetes: billetes 
rivera: rivera 
yariel: yariel 
boricuas: boricuas 
track: tracks track 
roof: roof 
mario: mario 
rock: rocks 
policy: policy 
thrall: thrall 
publisher: publisher 
malet: malet 
etc: etc 
sell: sell 
fran: fran 
pin: pin 
az: az 
stuntin: stuntin 
entrada: entrada 
edit: edit 
summer: summer 
regalan: regalan 
bobby: bobby 
annotation: annotation 
perform: perform 
holly: holly 
bbno: bbno 
bank: bank 
nigga: niggas 
best: best 
religion: religion 
harrell: harrell 
told: told 
shaftizm: shaftizm 
genius: genius 
im: im 
nick: nick 
activos: activos 
gente: gente 
johnny: johnny 
sample: samples sample 
featuring: featuring 
tu: tu 
year: year 
press: press 
cut: cut 
club: club 
rap: rap 
liv: liv 
maidixierekt: maidixierekt 
pt: pt 
mike: mike 
bersetzungen: bersetzungen 
programmer: programmer 
long: long 
ausserkontrolle: ausserkontrolle 
lopez: lopez 
latino: latino 
rossa: rossa 
arranca: arranca 
associate: associate 
curtain: curtains 
u: u us 
bo: bo 
believe: believe 
verified: verified 
n: n 
female: female 
number: number 
g: g 
primary: primary 
lily: lily 
diles: diles 
show: show 
triunfo: triunfo 
tengo: tengo 
knowledge: knowledge 
simone: simone 
every: every 
tambi: tambi 
available: available 
prohibido: prohibido 
bop: bop 
make: make 
bardi: bardi 
salgo: salgo 
dream: dream 
vargas: vargas 
cruz: cruz 
death: death 
line: lines 
licensing: licensing 
j: j 
somali: somali 
diop: diop 
assistant: assistant 
sony: sony 
yo: yo 
chart: chart charts 
stu: stu 
brathwaite: brathwaite 
guest: guest 
pen: pen 
vinyl: vinyl 
nederland: nederlands 
mu: mu 
infectious: infectious 
say: say 
kuk: kuk 
peluca: peluca 
ol: ol 
forum: forum 
jesucristo: jesucristo 
manny: manny 
bowl: bowl 
traducciones: traducciones 
lvs: lvs 
said: said 
advertise: advertise 
shakira: shakira 
ai: aises ais 
editor: editor 
virgin: virgin 
acento: acento 
closet: closet 
colombianas: colombianas 
additional: additional 
watch: watch 
add: add 
garnered: garnered 
control: controls 
charyt: charyt 
understand: understand 
guide: guide 
bonilla: bonilla 
toto: toto 
please: please 
handsome: handsome 
washpoppin: washpoppin 
emmanuelle: emmanuelle 
school: school 
clarit: clarit 
promote: promote 
flaunting: flaunting 
kobalt: kobalt 
la: las la 
copyright: copyright 
singh: singh 
wish: wish 
biggest: biggest 
job: jobs 
cabr: cabr 
bold: bold 
sabaka: sabaka 
emc: emc 
f: f 
everyone: everyone 
smb: smb 
dollar: dollars dollar 
cover: cover covers 
en: en 
chappell: chappell 
contact: contact 
whilst: whilst 
pi: pi 
commissioner: commissioner 
state: state 
casa: casa 
mami: mami 
nervous: nervous 
operaci: operaci 
ml: ml 
brooklyn: brooklyn 
mira: mira 
edd: edd 
plaza: plaza 
also: also 
distributor: distributor 
became: became 
decade: decade 
translation: translations translation 
traducci: traducci 
hubo: hubo 
mozzik: mozzik 
hookah: hookah 
hacer: hacer 
close: close 
bersetzung: bersetzung 
body: body 
white: white 
kallman: kallman 
assad: assad 
fact: facts 
ending: ending 
end: end 
ce: ce 
halftime: halftime 
klenord: klenord 
bish: bish 
shinin: shinin 
gucci: gucci 
youtube: youtube 
lalala: lalala 
cancel: cancel 
pues: pues 
trap: trap 
longitude: longitude 
z: z 
compras: compras 
record: record records 
convinced: convinced 
president: president 
mastering: mastering 
emi: emi 
new: new 
dentro: dentro 
look: look 
welcome: welcome 
party: party 
top: top 
january: january 
pete: pete 
picor: picor 
trato: trato 
noah: noah 
term: terms 
donde: donde 
seeley: seeley 
chance: chance 
tune: tunes 
semper: semper 
goza: goza 
interpolate: interpolate 
whopper: whopper 
chain: chain 
driver: driver 
sensaci: sensaci 
vamos: vamos 
grand: grand 
hop: hop 
driving: driving 
amar: amar 
blow: blow 
aise: aise 
embed: embed 
first: first 
seller: sellers 
bang: bang 
pecho: pecho 
pero: pero 
conocen: conocen 
universal: universal 
colombian: colombian 
ft: ft 
guerrero: guerrero 
ever: ever 
collaborated: collaborated 
hot: hot 
radio: radio 
influence: influences 
ultimate: ultimate 
gaga: gaga 
wrong: wrong 
eif: eif 
disco: disco 
super: super 
distinguish: distinguish 
million: million 
tenis: tenis 
lilly: lilly 
halal: halal 
ching: ching 
source: source 
need: need 
sign: sign 
q: q 
reciben: reciben 
stay: stay 
chaves: chaves 
pop: pop 
r: r 
raza: raza 
joseph: joseph 
colin: colin 
carajo: carajo 
rina: rina 
fur: fur 
fue: fue 
minute: minutes 
spanish: spanish 
smith: smith 
llc: llc 
jimmy: jimmy 
bajo: bajo 
qu: qu 
tainy: tainy 
insight: insight 
ya: ya 
obama: obama 
expand: expand 
luian: luian 
big: big 
recording: recording 
april: april 
como: como 
rima: rimas 
repeating: repeating 
iz: iz 
rc: rc 
love: love 
hit: hit 
viajes: viajes 
publishing: publishing 
ex: exes 
maribel: maribel 
date: date 
culo: culo 
skrrt: skrrt 
platinum: platinum 
girl: girls 
c: c 
rodriguez: rodriguez 
text: texts 
hugo: hugo 
ak: ak 
dillon: dillon 
jennifer: jennifer 
sorry: sorry 
mashup: mashup 
sock: socks 
swanqo: swanqo 
ebonie: ebonie 
explaining: explaining 
h: h 
individual: individual 
cuny: cuny 
single: single 
ansen: ansen 
know: know 
louie: louie 
personal: personal 
transcription: transcription 
signin: signin 
might: might 
benny: benny 
hard: hard 
deal: deals 
dipper: dipper 
jeje: jeje 
cien: cien 
yeah: yeah 
turnin: turnin 
torres: torres 
jones: jones 
list: list 
cubanas: cubanas 
socan: socan 
balvin: balvin 
warner: warner 
vocal: vocals 
kim: kim 
gomez: gomez 
beach: beach 
heritage: heritage 
yeh: yeh 
music: music 
l: l 
francis: francis 
kingdom: kingdom 
peter: peter 
live: live 
flexing: flexing 
energetic: energetic 
question: question 
producer: producer 
mueve: mueve 
killa: killa 
diablo: diablo 
drop: drop 
gotta: gotta 
yellow: yellow 
kb: kb 
lady: lady 
produced: produced 
reggaet: reggaet 
learn: learn 
espa: espa 
pabon: pabon 
shop: shop 
car: car 
verse: verse 
newton: newton 
vo: vo 
executive: executive 
ssj: ssj 
sarah: sarah 
dj: dj 
brain: brains 
administration: administration 
se: se 
scholar: scholars 
venezolanas: venezolanas 
alesso: alesso 
december: december 
viva: viva 
interpolation: interpolations 
vio: vio 
visto: visto 
tinker: tinker 
entertainment: entertainment 
raphael: raphael 
beat: beat 
leslie: leslie 
atv: atv 
