tradu: tradu 
italic: italics 
mastered: mastered 
chorus: chorus 
thought: thoughts 
still: still 
section: section 
incidentally: incidentally 
chump: chump 
gardner: gardner 
killbunk: killbunk 
nobody: nobody 
kiss: kiss 
whoo: whoo 
baker: baker 
conkin: conkin 
okay: okay 
remixes: remixes 
mark: marks 
mathers: mathers 
traductions: traductions 
collection: collection 
use: use 
lyric: lyrics lyric 
bad: bad 
give: give 
stop: stop 
information: information 
xv: xv 
shady: shady 
kid: kids kid 
crazy: crazy 
w: w 
walk: walk 
beginnin: beginnin 
world: world 
holding: holdings 
tony: tony 
traduction: traduction 
oh: oh 
goin: goin 
v: v 
baby: baby 
ha: ha 
shroom: shroom 
freq: freq 
desperation: desperation 
reach: reach 
back: back 
much: much 
dance: dance 
grundman: grundman 
privacy: privacy 
artist: artists 
sheep: sheep 
russell: russell 
go: go 
child: children 
jeff: jeff 
eviri: eviri 
frisk: frisk 
earworm: earworm 
answer: answer 
bed: bed 
jon: jon 
beautiful: beautiful 
share: share 
spin: spin 
never: never 
far: far 
wanderin: wanderin 
creeper: creeper 
k: k 
think: think 
wicked: wicked 
co: co 
voice: voice voices 
guideline: guidelines 
check: check 
conquer: conquer 
song: song songs 
et: et 
credit: credits 
blackwood: blackwood 
even: even 
engineer: engineer 
thing: thing 
post: post 
rich: rich 
bebe: bebe 
cashonlee: cashonlee 
lottery: lottery 
instrumentation: instrumentation 
huge: huge 
eat: eat 
el: el 
real: real 
ii: ii 
brainless: brainless 
comment: comment comments 
frequency: frequency 
tomorrow: tomorrow 
ay: ay 
contributor: contributor contributors 
actually: actually 
effigy: effigy 
tryin: tryin 
read: read 
iragorri: iragorri 
lil: lil 
sleep: sleep 
part: parts part 
background: background 
header: headers 
abused: abused 
relates: relates 
ask: ask 
written: written 
performance: performance 
hemii: hemii 
format: format 
vocalist: vocalists 
cupid: cupid 
developer: developers 
parking: parking 
mauricio: mauricio 
perhaps: perhaps 
taken: taken 
collaboration: collaboration 
phasa: phasa 
bmg: bmg 
director: director 
fallin: fallin 
remix: remix 
die: die 
rk: rk 
mixing: mixing 
view: view 
considering: considering 
mc: mcs 
musical: musical 
visit: visit 
guytv: guytv 
created: created 
shit: shit 
game: game 
head: head 
yoo: yoo 
p: p 
ooh: ooh 
killed: killed 
see: see 
keith: keith 
tool: tool 
kool: kool 
somebody: somebody 
call: call 
hook: hook 
broken: broken 
different: different 
united: united 
sanito: sanito 
feelin: feelin 
knockin: knockin 
vida: vida 
maybe: maybe 
e: es e 
video: videos video 
win: win 
featured: featured 
groundhog: groundhog 
cool: cool 
nut: nuts 
nothin: nothin 
get: gets get 
home: home 
bart: bart 
tag: tags 
parody: parody 
stumbled: stumbled 
keyboard: keyboards 
holdin: holdin 
ascap: ascap 
spawn: spawn 
blaze: blaze 
dre: dre 
got: got 
pentatonix: pentatonix 
gary: gary 
rhyme: rhyme 
type: type 
monster: monster 
release: release 
straightjacket: straightjacket 
b: b 
munna: munna 
headlight: headlights 
pluffaduff: pluffaduff 
evil: evil 
vision: vision 
right: rights 
joe: joe 
group: group 
bmi: bmi 
together: together 
intro: intro 
french: french 
wilson: wilson 
macallan: macallan 
x: x 
one: one 
feel: feels 
transcriber: transcribers 
elevate: elevate 
interventionist: interventionist 
bernie: bernie 
lot: lot 
luis: luis 
policy: policy 
publisher: publisher 
reason: reason 
living: living 
alternative: alternative 
etc: etc 
sell: sell 
friend: friends 
could: could 
fran: fran 
chernobyl: chernobyl 
winnin: winnin 
portugu: portugu 
dr: dr 
conflict: conflict 
loose: loose 
lose: lose 
zay: zay 
vanvonderen: vanvonderen 
used: used 
annotation: annotation 
wonder: wonder wonders 
imposter: imposter 
october: october 
evolution: evolution 
along: along 
best: best 
david: david 
rihanna: rihanna 
told: told 
genius: genius 
somethin: somethin 
steam: steam 
sample: samples sample 
featuring: featuring 
day: days day 
aalias: aalias 
press: press 
freestyle: freestyle 
mind: mind 
rap: rap 
worked: worked 
bittersweet: bittersweet 
mike: mike 
weirder: weirder 
halocene: halocene 
grammys: grammys 
u: u us 
sometimes: sometimes 
edition: edition 
rj: rj 
verified: verified 
thai: thai 
n: n 
rmx: rmx 
colston: colston 
contemporary: contemporary 
onto: onto 
face: face 
g: g 
primary: primary 
show: show 
mixed: mixed 
leaf: leaf 
left: left 
asshole: asshole 
knowledge: knowledge 
every: every 
excuse: excuse excuses 
make: make 
intervene: intervene 
bumblebee: bumblebee 
death: death 
line: lines 
brasil: brasil 
gold: gold 
athanasiou: athanasiou 
j: j 
licensing: licensing 
assistant: assistant 
bruce: bruce 
toby: toby 
roomie: roomie 
wantin: wantin 
italiane: italiane 
killin: killin 
relayin: relayin 
true: true 
say: say 
sleepwalkin: sleepwalkin 
losin: losin 
newsweek: newsweek 
messenger: messenger 
forum: forum 
confusing: confusing 
inside: inside 
civilian: civilian 
cake: cake 
said: said 
advertise: advertise 
ai: aises ais 
twin: twin 
additional: additional 
add: add 
straw: straw 
blew: blew 
marshall: marshall 
understand: understand 
guide: guide 
beggar: beggars 
traduzione: traduzione 
soda: soda 
blood: blood 
shawybee: shawybee 
promote: promote 
save: save 
hip: hip 
nerdout: nerdout 
job: jobs 
hundred: hundred 
biggest: biggest 
copyright: copyright 
bold: bold 
wee: wee 
numb: numb 
f: f 
cover: cover covers 
among: among 
contact: contact 
em: em 
turkish: turkish 
state: state 
sayin: sayin 
seize: seize 
maki: maki 
ml: ml 
guwapboiii: guwapboiii 
alone: alone 
also: also 
hee: hee 
played: played 
translation: translations translation 
rumpelstiltskin: rumpelstiltskin 
ego: ego 
boi: boi 
comin: comin 
fact: facts 
odel: odel 
resto: resto 
haystack: haystack 
yodel: yodel 
cancel: cancel 
z: z 
ocd: ocd 
record: record records 
wave: wave 
balloon: balloon 
turn: turn 
mastering: mastering 
way: way ways 
emi: emi 
berzerk: berzerk 
coo: coo 
alter: alter 
made: made 
front: front 
term: terms 
milli: milli 
indigo: indigo 
take: take 
payback: payback 
interpolate: interpolate 
pumped: pumped 
god: god 
drum: drums 
james: james 
hop: hop 
keep: keep 
mink: mink 
la: la 
aise: aise 
embed: embed 
michigan: michigan 
exetra: exetra 
universal: universal 
ft: ft 
campana: campana 
time: time 
amongst: amongst 
collaborated: collaborated 
fame: fame 
sun: sun 
hot: hot 
lie: lie 
randler: randler 
strange: strange 
kooky: kooky 
well: well 
tyson: tyson 
chosen: chosen 
ultimate: ultimate 
sone: sone 
receive: receive 
fourth: fourth 
ink: ink 
like: like 
distinguish: distinguish 
guy: guy 
ponderin: ponderin 
million: million 
ironic: ironic 
two: two 
better: better 
demon: demons 
beatz: beatz 
went: went 
arthouse: arthouse 
source: source 
need: need 
sign: sign 
q: q 
legacy: legacy 
gave: gave 
pop: pop 
r: r 
attention: attention 
survival: survival 
choosey: choosey 
llc: llc 
insight: insight 
studio: studios 
squander: squander 
fla: fla 
emotional: emotional 
expand: expand 
justhis: justhis 
deluxe: deluxe 
recording: recording 
pain: pain 
great: great 
shawty: shawty 
portuguese: portuguese 
repeating: repeating 
dark: dark 
bellion: bellion 
track: track 
sung: sung 
love: love 
public: public 
hit: hit 
publishing: publishing 
sam: sam 
date: date 
poet: poet 
wanders: wanders 
platinum: platinum 
c: c 
annarhi: annarhi 
skit: skit 
martin: martin 
straight: straight 
h: h 
individual: individual 
shawlzee: shawlzee 
stronger: stronger 
certification: certifications 
instalok: instalok 
cause: cause 
lp: lp 
single: single 
shoot: shoot 
award: award 
shrink: shrink 
know: know 
personal: personal 
eminem: eminem 
transcription: transcription 
chart: charts 
might: might 
yeah: yeah 
moment: moment 
rexha: rexha 
brian: brian 
breath: breath 
vocal: vocals 
inflated: inflated 
gettin: gettin 
italian: italian 
music: music 
l: l 
struggle: struggle 
lee: lee 
plague: plague 
question: question 
producer: producer 
drop: drop 
shop: shop 
feeling: feeling 
produced: produced 
learn: learn 
trax: trax 
ygn: ygn 
spilled: spilled 
draft: draft 
wanted: wanted 
verse: verse 
young: young 
jonas: jonas 
recorded: recorded 
fantasy: fantasy 
microphone: microphone 
olsson: olsson 
italiana: italiana 
dj: dj 
ferndale: ferndale 
heartman: heartman 
se: se 
scholar: scholars 
yonder: yonder 
viva: viva 
fuckin: fuckin 
interpolation: interpolations 
guess: guess 
hoo: hoo 
conjurin: conjurin 
version: version 
traduzioni: traduzioni 
entertainment: entertainment 
lunity: lunity 
audio: audio 
italiano: italiano 
regular: regular 
