equality: equality 
atlantic: atlantic 
tradu: tradu 
isosine: isosine 
jackhoeting: jackhoeting 
italic: italics 
woo: woo 
around: around 
chorus: chorus choruses 
poverty: poverty 
section: section 
girl: girl girls 
awaken: awaken 
nederlandse: nederlandse 
nobody: nobody 
solidshibe: solidshibe 
ad: ad 
libs: libs 
cyclical: cyclical 
baker: baker 
deutsch: deutsch 
good: good 
roc: roc 
bare: bare 
remixes: remixes 
carry: carry 
mi: mi 
kyle: kyle 
reference: reference 
traductions: traductions 
collection: collection 
tell: tell 
use: use 
ended: ended 
corp: corp 
lyric: lyrics lyric 
outro: outro 
aged: aged 
guitar: guitar 
information: information 
demo: demo 
rapper: rapper 
azerrz: azerrz 
w: w 
world: world 
holding: holdings 
fresilli: fresilli 
unbothered: unbothered 
traduction: traduction 
thug: thug 
mcdj: mcdj 
v: v 
ludovin: ludovin 
ha: ha 
robloxia: robloxia 
industry: industries 
cold: cold 
area: area 
vertaling: vertaling 
violence: violence 
wanna: wanna 
kodak: kodak 
alex: alex 
kurt: kurt 
dance: dance dances 
acrylo: acrylo 
privacy: privacy 
artist: artists artist 
want: want 
yes: yes 
ayy: ayy 
directed: directed 
sza: sza 
gleefully: gleefully 
nonstop: nonstop 
benjadoes: benjadoes 
form: form 
evaristobeatbox: evaristobeatbox 
go: go 
pasta: pasta 
loved: loved 
ludwig: ludwig 
child: children 
bro: bro 
another: another 
earworm: earworm 
move: move 
answer: answer 
share: share 
dru: dru 
dropped: dropped 
second: second 
frantically: frantically 
playtime: playtime 
k: k 
guideline: guidelines 
check: check 
song: song songs 
guram: guram 
credit: credits 
expression: expressions 
megamashup: megamashup 
deutsche: deutsche 
circulation: circulation 
man: man 
gonna: gonna 
reminder: reminder 
appearance: appearance 
mashups: mashups 
even: even 
engineer: engineer 
dancing: dancing 
happy: happy 
youtobe: youtobe 
shake: shake 
money: money 
warehouse: warehouse 
songview: songview 
retrospectiva: retrospectiva 
comment: comment comments 
turmoil: turmoil 
hardcore: hardcore 
calvin: calvin 
commentary: commentary 
verse: verses verse 
national: national 
contributor: contributor contributors 
actually: actually 
shaan: shaan 
read: read 
word: word 
childish: childish 
jxmmi: jxmmi 
lil: lil 
savage: savage 
free: free 
part: parts part 
background: background 
header: headers 
next: next 
papaya: papaya 
ask: ask 
written: written 
performance: performance 
format: format 
doa: doa 
vocalist: vocalists 
scene: scenes scene 
american: american americans 
isto: isto 
developer: developers 
probably: probably 
bridge: bridge 
expensive: expensive 
problem: problems 
america: america 
phasa: phasa 
phonographic: phonographic 
director: director 
saturday: saturday 
remix: remix 
menebhi: menebhi 
die: die 
mixing: mixing 
view: view 
musical: musical 
xexu: xexu 
visit: visit 
resonance: resonance 
created: created 
billboard: billboard 
pad: pad 
studio: studio 
rumba: rumba 
p: p 
ooh: ooh 
gruzin: gruzin 
schneider: schneider 
uh: uh 
tool: tool 
facial: facial 
meaning: meaning 
accolade: accolades 
wolf: wolf 
somebody: somebody 
medium: media 
thatpunchkid: thatpunchkid 
fitted: fitted 
broken: broken 
different: different 
united: united 
esto: esto 
ignorant: ignorant 
feature: feature 
fight: fight 
vida: vida 
stoner: stoner 
rock: rock 
red: red 
e: es e 
video: videos video 
featured: featured 
album: album 
tag: tags 
nothin: nothin 
bart: bart 
pretty: pretty 
label: label 
mothafuckas: mothafuckas 
mc: mc 
dialogo: dialogo 
parody: parody parodys 
island: island 
matter: matter 
al: al 
got: got 
culture: culture 
include: include 
type: type 
dancer: dancers 
b: b 
release: release 
blancoblk: blancoblk 
paye: paye 
minecraft: minecraft 
right: rights 
group: group 
bay: bay 
quavo: quavo 
hear: hear 
bmi: bmi 
blaow: blaow 
intro: intro 
french: french 
monk: monk 
horse: horse 
symbolism: symbolism 
nature: nature 
popular: popular 
one: one 
feel: feels feel 
x: x 
transcriber: transcribers 
night: night 
following: following 
away: away 
received: received 
tumult: tumult 
policy: policy 
publisher: publisher 
bigg: bigg 
falcon: falcon 
slim: slim 
kendrick: kendrick 
kesha: kesha 
tamerlane: tamerlane 
choir: choir 
reality: reality 
etc: etc 
sell: sell 
could: could 
blackman: blackman 
fran: fran 
took: took 
portugu: portugu 
minute: minute minutes 
ethnicity: ethnicity 
atlanta: atlanta 
carefree: carefree 
anthem: anthem 
roba: roba 
edit: edit 
summer: summer 
inevitably: inevitably 
annotation: annotation 
perform: perform 
baila: baila 
mob: mob 
russia: russia 
barcode: barcode 
daymanoursavior: daymanoursavior 
brutality: brutality 
along: along 
instagram: instagram 
woah: woah 
halwani: halwani 
oaxaca: oaxaca 
uproar: uproar 
later: later 
told: told 
hada: hada 
genius: genius 
remain: remain 
wakanda: wakanda 
shark: sharks 
satire: satire 
people: people 
server: server 
sample: samples sample 
hovansky: hovansky 
glover: glover 
press: press 
russian: russian 
performed: performed 
nigeria: nigeria 
aggressive: aggressive 
rap: rap 
wunderworld: wunderworld 
year: years 
mike: mike 
peru: peru 
animada: animada 
bersetzungen: bersetzungen 
allude: allude 
long: long 
trend: trends trend 
similarity: similarities 
placated: placated 
gon: gon 
lead: lead 
u: u us 
videogamedunkey: videogamedunkey 
guerilla: guerilla 
verified: verified 
amid: amid 
thai: thai 
n: n 
rynx: rynx 
falz: falz 
g: g 
noobersingshd: noobersingshd 
felckin: felckin 
grandma: grandma 
contrast: contrast contrasts 
pharaoh: pharaoh 
maybeanton: maybeanton 
mixed: mixed 
knowledge: knowledge 
every: every 
make: make 
rapped: rapped 
death: death 
line: lines 
brasil: brasil 
licensing: licensing 
unotheactivist: unotheactivist 
j: j 
assistant: assistant 
german: german 
sony: sony 
posting: posting 
life: life 
summertime: summertime 
dacota: dacota 
nederland: nederlands 
blocka: blocka 
vertalingen: vertalingen 
police: police 
zak: zak 
awesome: awesome 
ol: ol 
coincided: coincided 
forum: forum 
quentin: quentin 
traducciones: traducciones 
rodrigo: rodrigo 
brigitte: brigitte 
contributed: contributed 
mackin: mackin 
advertise: advertise 
naked: naked 
ai: aises ais 
dawg: dawg 
additional: additional 
watch: watch 
kapearnick: kapearnick 
add: add 
hey: hey 
unconcerned: unconcerned 
understand: understand 
guide: guide 
history: history 
whenever: whenever 
extreme: extreme 
dropping: dropping 
kurby: kurby 
shooting: shooting 
soda: soda 
school: school 
promote: promote 
geekin: geekin 
hip: hip 
kobalt: kobalt 
copyright: copyright 
singh: singh 
biggest: biggest 
job: jobs 
bold: bold 
actor: actor 
ghantir: ghantir 
f: f 
appears: appears 
backyard: backyard 
contact: contact 
em: em 
rca: rca 
state: state 
slime: slime 
collaborator: collaborator 
yaminobahamut: yaminobahamut 
ml: ml 
trippin: trippin 
rapping: rapping 
also: also 
distributor: distributor 
get: get 
slavery: slavery 
felipe: felipe 
translation: translations translation 
traducci: traducci 
castro: castro 
final: final 
harley: harley 
bersetzung: bersetzung 
white: white 
hilum: hila 
nation: nation 
seriousness: seriousness 
fact: facts 
chase: chases 
end: end 
dutch: dutch 
iraq: iraq 
kettle: kettle 
control: control 
nz: nz 
mood: mood 
gucci: gucci 
chicken: chicken 
cancel: cancel 
trap: trap 
political: political 
race: race 
chaotic: chaotic 
z: z 
basedgod: basedgod 
lukach: lukach 
mastering: mastering 
new: new 
dancin: dancin 
look: look 
leader: leader 
vincent: vincent 
welcome: welcome 
party: party 
self: self 
drivin: drivin 
ugh: ugh 
chooses: chooses 
ali: ali 
term: terms 
beginning: beginning 
celly: celly 
uniform: uniforms 
take: take 
black: black 
politics: politics 
lamar: lamar 
interpolate: interpolate 
seemingly: seemingly 
migos: migos 
hop: hop 
la: la 
checked: checked 
comparison: comparison 
livin: livin 
blow: blow 
trying: trying 
aise: aise 
embed: embed 
whole: whole 
outfit: outfit 
first: first 
confirm: confirm 
castanhari: castanhari 
jb: jb 
universal: universal 
ft: ft 
hapancake: hapancake 
time: time 
gambino: gambino 
donald: donald 
last: last 
ongoing: ongoing 
entire: entire 
shift: shifts 
houa: houa 
hunnid: hunnid 
african: african 
hot: hot 
amiah: amiah 
since: since 
missing: missing 
well: well 
ultimate: ultimate 
refrain: refrain 
exhan: exhan 
like: like 
guy: guy 
distinguish: distinguish 
super: super 
wing: wing 
cover: covers 
slippin: slippin 
whippin: whippin 
perception: perception 
hayden: hayden 
dreammix: dreammix 
frequent: frequent 
adlib: adlib 
uk: uk 
source: source 
eta: eta 
racism: racism 
sign: sign 
foreigns: foreigns 
flyingkitty: flyingkitty 
hilm: hilm 
q: q 
waa: waa 
pop: pop 
r: r 
bag: bag 
colin: colin 
cameo: cameo 
gun: gun guns 
spanish: spanish 
country: country 
rothstein: rothstein 
llc: llc 
ransson: ransson 
insight: insight 
colombiano: colombiano 
obama: obama 
expand: expand 
monsterr: monsterr 
cargo: cargo 
big: big 
recording: recording 
garc: garc 
experience: experience 
portuguese: portuguese 
may: may 
tiad: tiad 
bien: bien 
repeating: repeating 
bino: bino 
dark: dark 
murai: murai 
track: track 
discussed: discussed 
luke: luke 
love: love 
hit: hit 
andre: andre 
find: find 
hold: hold 
portrays: portrays 
meme: meme 
publishing: publishing 
work: work 
owe: owe 
hiro: hiro 
soul: soul 
institutionalized: institutionalized 
date: date 
skrrt: skrrt 
frame: frame 
maroc: maroc 
c: c 
reservoir: reservoir 
megamix: megamix 
hugo: hugo 
strap: strap 
plug: plug 
conscious: conscious 
straight: straight 
dog: dog 
mashup: mashup 
interview: interview 
h: h 
individual: individual 
tumay: tumay 
escape: escape 
single: single 
riley: riley 
know: know 
cultural: cultural 
personal: personal 
jase: jase 
blocboy: blocboy 
transcription: transcription 
chart: charts 
might: might 
bozzi: bozzi 
starfox: starfox 
yeah: yeah 
turnin: turnin 
dope: dope 
list: list 
warner: warner 
catch: catch 
running: running 
vocal: vocals 
band: bands 
contraband: contraband 
record: records 
however: however 
essay: essays 
music: music 
l: l 
short: short 
willfully: willfully 
lee: lee 
live: live 
knock: knock 
darkened: darkened 
question: question 
orange: orange 
magic: magic 
drop: drop 
gotta: gotta 
shop: shop 
espa: espa 
produced: produced 
learn: learn 
brutal: brutal 
downfall: downfall 
rainwater: rainwater 
kenneled: kenneled 
often: often 
young: young 
juxtaposing: juxtaposing 
guava: guava 
dj: dj 
scholar: scholars 
seen: seen 
viva: viva 
beit: beit 
interpolation: interpolations 
neo: neo 
samshit: samshit 
film: film 
version: version 
entertainment: entertainment 
mack: mack 
