catley: catley 
talk: talk 
tradu: tradu 
isosine: isosine 
italic: italics 
jonsin: jonsin 
around: around 
chorus: chorus 
staple: staple 
moses: moses 
blaque: blaque 
still: still 
rosen: rosen 
section: section 
grooming: grooming 
girl: girl girls 
vkie: vkie 
ramos: ramos 
noelia: noelia 
kiss: kiss 
let: let 
throughout: throughout 
jenny: jenny 
fuliane: fuliane 
nigga: nigga 
terrell: terrell 
season: season 
ze: ze 
coy: coy 
deutsch: deutsch 
ac: ac 
bless: bless 
remixes: remixes 
breve: breves 
released: released 
ready: ready 
collection: collection 
neck: neck 
perry: perry 
zanon: zanon 
roadtrip: roadtrip 
use: use 
latinautorperf: latinautorperf 
grip: grip 
corp: corp 
lyric: lyrics lyric 
bad: bad 
razorback: razorback 
smino: smino 
outro: outro 
tint: tint 
deep: deep 
chill: chill 
zamor: zamor 
chief: chief 
adjusted: adjusted 
shangobunmi: shangobunmi 
stephen: stephen 
information: information 
demo: demo 
toppin: toppin 
boy: boy 
trade: trade 
jordan: jordan 
personality: personality 
kid: kids 
personnel: personnel 
w: w 
world: world 
holding: holdings 
satchel: satchel 
fletcher: fletcher 
rewind: rewind 
de: de 
bychurch: bychurch 
goin: goin 
gale: gale 
venture: ventures 
v: v 
bug: bugs 
massaru: massaru 
fouine: fouine 
try: try 
taj: taj 
option: options 
back: back 
jazmine: jazmine 
seventh: seventh 
phil: phil 
stylist: stylist 
stuart: stuart 
alex: alex 
fortnite: fortnite 
kurt: kurt 
oram: oram 
meyer: meyer 
deezle: deezle 
privacy: privacy 
artist: artists 
want: want 
yes: yes 
dotheshiggy: dotheshiggy 
moonoo: moonoo 
ayy: ayy 
directed: directed 
sargsyan: sargsyan 
shield: shields 
nonstop: nonstop 
care: care 
guiterrez: guiterrez 
juhn: juhn 
token: token 
loved: loved 
rizzie: rizzie 
go: go 
luvariez: luvariez 
bryon: bryon 
miami: miami 
juliana: juliana 
mason: mason 
buy: buy 
another: another 
harlan: harlan 
dimitri: dimitri 
tracy: tracy 
robyn: robyn 
ubem: ubem 
kidz: kidz 
lengyel: lengyel 
earworm: earworm 
answer: answer 
davvero: davvero 
share: share 
feat: feat 
spend: spend 
valesquez: valesquez 
gang: gang 
robert: robert 
second: second 
never: never 
wg: wg 
moffett: moffett 
playtime: playtime 
k: k 
meno: meno 
tim: tim 
fenty: fenty 
acted: acted 
guideline: guidelines 
beanpole: beanpole 
check: check 
song: song songs 
bazil: bazil 
credit: credits 
clap: clap 
impel: impel 
eddie: eddie 
deutsche: deutsche 
webber: webber 
critchlow: critchlow 
maik: maik 
upset: upset 
wayne: wayne 
mashups: mashups 
block: block 
even: even 
lazza: lazza 
engineer: engineer 
dancing: dancing 
happy: happy 
wardrobe: wardrobe 
liar: liar 
santiago: santiago 
titled: titled 
triggaman: triggaman 
cierra: cierra 
comedian: comedian 
skate: skate 
money: money 
rayford: rayford 
soup: soup 
el: el 
real: real 
ii: ii 
songview: songview 
keef: keef 
comment: comment comments 
operator: operator 
payne: payne 
palmer: palmer 
arsenault: arsenault 
band: band 
contributor: contributor contributors 
yung: yung 
replicate: replicate 
read: read 
childish: childish 
lil: lil 
meme: memes meme 
riaa: riaa 
part: parts part 
header: headers 
right: right rights 
dee: dee 
ask: ask 
written: written 
webley: webley 
performance: performance 
format: format 
eighth: eighth 
lakeisha: lakeisha 
sierra: sierra 
vocalist: vocalists 
strip: strip 
mida: mida 
developer: developers 
magnolia: magnolia 
paolo: paolo 
orville: orville 
pham: pham 
zucc: zucc 
phasa: phasa 
ballin: ballin 
tie: ties 
john: john 
director: director 
phonographic: phonographic 
dit: dit 
drinaskye: drinaskye 
remix: remix 
due: due 
popped: popped 
waghorne: waghorne 
phoenix: phoenix 
altered: altered 
kasey: kasey 
electric: electric 
mixing: mixing 
jesse: jesse 
view: view 
resha: resha 
campbell: campbell 
musical: musical 
visit: visit 
rashad: rashad 
belong: belong 
tierra: tierra 
billboard: billboard 
shit: shit 
reid: reid 
created: created 
studio: studio 
lizama: lizama 
june: june 
head: head 
p: p 
jamar: jamar 
play: play 
see: see 
schneider: schneider 
technician: technician 
mellany: mellany 
sullivan: sullivan 
included: included 
yacine: yacine 
hook: hook 
medium: media 
gonzalez: gonzalez 
ron: ron 
broken: broken 
different: different 
cam: cam 
united: united 
devvon: devvon 
washington: washington 
username: username 
frenna: frenna 
bright: bright 
park: park 
e: es e 
video: videos video 
dodson: dodson 
kobe: kobe 
featured: featured 
light: light lights 
shorty: shorty 
album: album 
sampled: sampled 
hall: hall 
taylor: taylor 
word: words 
lollipop: lollipop 
tag: tags 
grant: grants 
parody: parody 
farid: farid 
hawkins: hawkins 
matter: matter 
christina: christina 
phylicia: phylicia 
al: al 
ascap: ascap 
jeopardy: jeopardy 
got: got 
roncesvalles: roncesvalles 
bj: bj 
choice: choices 
publish: publish 
mcguire: mcguire 
hammond: hammond 
include: include 
type: type 
location: locations 
autumn: autumn 
petikyan: petikyan 
dancer: dancers 
release: release 
b: b 
stoned: stoned 
di: di 
sanchez: sanchez 
kendra: kendra 
yup: yup 
gaffer: gaffer 
bitch: bitches 
speakonia: speakonia 
revolved: revolved 
ginanni: ginanni 
goins: goins 
group: group 
jump: jump 
kgoldn: kgoldn 
would: would 
trippie: trippie 
bmi: bmi 
quavo: quavo 
musicologo: musicologo 
intro: intro 
lundy: lundy 
wilson: wilson 
popular: popular 
one: one 
jimipub: jimipub 
x: x 
transcriber: transcribers 
elevate: elevate 
green: green 
wild: wild 
following: following 
luqi: luqi 
colorist: colorist 
jonathan: jonathan 
isa: isa 
challenge: challenge 
macklemore: macklemore 
policy: policy 
verdiend: verdiend 
cafun: cafun 
publisher: publisher 
sa: sa 
dream: dreams 
ashley: ashley 
tamerlane: tamerlane 
latoya: latoya 
tanesha: tanesha 
zazie: zazie 
beside: beside 
etc: etc 
landry: landry 
cardcaptorxp: cardcaptorxp 
sell: sell 
portugu: portugu 
greg: greg 
collier: collier 
paul: paul 
dreezy: dreezy 
producing: producing 
atlanta: atlanta 
static: static 
distant: distant 
summer: summer 
sewerperson: sewerperson 
lehn: lehn 
marley: marley 
annotation: annotation 
perform: perform 
hilliard: hilliard 
mob: mob 
canada: canada 
instagram: instagram 
jazz: jazz 
damian: damian 
best: best 
reptilelegityt: reptilelegityt 
kissin: kissin 
ben: ben 
rivas: rivas 
dune: dunes 
richard: richard 
henny: henny 
david: david 
diamond: diamonds 
hymes: hymes 
genius: genius 
ethan: ethan 
scott: scott 
rokael: rokael 
ksyn: ksyn 
havar: havar 
amra: amra 
baez: baez 
manager: manager 
johnny: johnny 
sample: samples sample 
people: people 
day: days day 
blue: blue 
glover: glover 
nooit: nooit 
press: press 
starring: starring 
papi: papi 
club: club 
milky: milky 
freestyle: freestyle 
smoking: smoking 
rap: rap 
blake: blake 
upbeat: upbeat 
sound: sound 
year: years 
choreographer: choreographer 
richoux: richoux 
gabby: gabby 
pt: pt 
mike: mike 
bersetzungen: bersetzungen 
gu: gus 
learnin: learnin 
beetz: beetz 
major: major 
emma: emma 
aa: aa 
sherlock: sherlock 
drew: drew 
ursin: ursin 
groove: groove 
u: u us 
jamule: jamule 
edition: edition 
verified: verified 
heavily: heavily 
kiki: kiki 
thai: thai 
frio: frio 
saluki: saluki 
network: network 
n: n 
haynes: haynes 
safe: safe 
contemporary: contemporary 
g: g 
photo: photo 
topping: topping 
durazo: durazo 
chad: chad 
letter: letter 
phone: phone 
wondering: wondering 
mixed: mixed 
show: show 
singing: singing 
knowledge: knowledge 
every: every 
haklum: haklum 
duy: duy 
rene: rene 
thats: thats 
jr: jr 
bop: bop 
city: city 
quad: quad 
make: make 
emotionless: emotionless 
velasco: velasco 
cruz: cruz 
crane: crane 
death: death 
vtr: vtr 
line: lines 
brasil: brasil 
licensing: licensing 
unotheactivist: unotheactivist 
anuel: anuel 
j: j 
member: members 
assistant: assistant 
toby: toby 
sony: sony 
ronnie: ronnie 
arrangement: arrangements 
yo: yo 
logistics: logistics 
jim: jim 
summertime: summertime 
dudu: dudu 
say: say 
ol: ol 
devil: devil 
rex: rex 
birthday: birthday 
orlando: orlando 
leadman: leadman 
forum: forum 
clyde: clyde 
schafter: schafter 
netflix: netflix 
traducciones: traducciones 
aptly: aptly 
said: said 
luisa: luisa 
contributed: contributed 
ffm: ffm 
evrard: evrard 
riding: riding 
advertise: advertise 
blaqnmild: blaqnmild 
editor: editor 
many: many 
additional: additional 
parma: parma 
stevenson: stevenson 
game: games 
meer: meer 
piki: piki 
campa: campa 
garnered: garnered 
add: add 
control: controls control 
august: august 
marshall: marshall 
dean: dean 
tanisha: tanisha 
understand: understand 
spy: spy 
guide: guide 
swear: swear 
gopnik: gopnik 
faruk: faruk 
chord: chords 
gotti: gotti 
evolved: evolved 
polanco: polanco 
ab: ab 
kenia: kenia 
rose: rose 
boom: boom 
royalty: royalty 
promote: promote 
hip: hip 
rahfield: rahfield 
kobalt: kobalt 
ride: rides 
homuth: homuth 
price: price 
jadakiss: jadakiss 
copyright: copyright 
based: based 
dragos: dragos 
biggest: biggest 
job: jobs 
nail: nails 
bold: bold 
fountain: fountain 
danzo: danzo 
plan: plan 
everyone: everyone 
photography: photography 
f: f 
cover: cover covers 
lauren: lauren 
becky: becky 
chappell: chappell 
contact: contact 
em: em 
initial: initial 
state: state 
yolonamia: yolonamia 
yaminobahamut: yaminobahamut 
stoppin: stoppin 
similar: similar 
ml: ml 
art: art 
card: card 
production: production 
laumar: laumar 
cappel: cappel 
ita: ita 
also: also 
ronald: ronald 
distributor: distributor 
get: get 
runnin: runnin 
lisa: lisa 
anderson: anderson 
management: management 
faraoni: faraoni 
kill: kill 
translation: translations translation 
traducci: traducci 
dei: dei 
sex: sex 
capito: capito 
code: code 
ego: ego 
hoover: hoover 
nato: nato 
goat: goats 
feeling: feelings 
final: final 
harley: harley 
yunk: yunk 
bersetzung: bersetzung 
haxi: haxi 
vega: vegas 
fact: facts 
end: end 
lipscomb: lipscomb 
interlude: interlude 
system: system 
cat: cats 
youtube: youtube 
chicken: chicken 
chris: chris 
bring: bring 
cancel: cancel 
trap: trap 
peak: peak 
volume: volume 
ply: plies 
z: z 
riki: riki 
mariah: mariah 
solar: solar 
widespread: widespread 
noel: noel 
wave: wave 
nice: nice 
lukach: lukach 
emi: emi 
new: new 
look: look 
mam: mam 
brandon: brandon 
vincent: vincent 
alter: alter 
moe: moe 
unit: unit 
top: top 
daar: daar 
polaris: polaris 
term: terms 
southern: southern 
without: without 
nd: nd 
thought: thought 
streaming: streaming 
salomon: salomon 
take: take 
poeta: poeta 
black: black 
original: original 
chance: chance 
joey: joey 
interpolate: interpolate 
latinautor: latinautor 
mavor: mavor 
cruzcontrolmusic: cruzcontrolmusic 
maratea: maratea 
god: god 
hop: hop 
la: la 
keep: keep 
bounce: bounce 
zucconi: zucconi 
casting: casting 
embed: embed 
mellygz: mellygz 
ibra: ibra 
first: first 
bang: bang 
universal: universal 
ft: ft 
worth: worth 
gambino: gambino 
donald: donald 
last: last 
ever: ever 
galaxy: galaxy 
wait: wait 
fame: fame 
hot: hot 
gabrielle: gabrielle 
three: three 
nailah: nailah 
influence: influences 
amiah: amiah 
ultimate: ultimate 
remote: remote 
ratchet: ratchet 
shoppin: shoppin 
soraya: soraya 
adopted: adopted 
monolyth: monolyth 
like: like 
keaton: keaton 
distinguish: distinguish 
super: super 
pw: pw 
huncho: huncho 
joke: joke 
two: two 
cmrra: cmrra 
breakdown: breakdown 
fuck: fuck 
apple: apple 
dababy: dababy 
cason: cason 
durotimi: durotimi 
source: source 
leave: leave 
need: need 
croosh: croosh 
hand: hand 
doug: doug 
sign: sign 
barbara: barbara 
q: q 
slack: slack 
champagne: champagne 
davis: davis 
pop: pop 
varnadore: varnadore 
r: r 
attention: attention 
place: place 
der: der 
vocal: vocal vocals 
survival: survival 
redd: redd 
gun: gun 
minute: minutes 
spanish: spanish 
collingsworth: collingsworth 
smith: smith 
biggy: biggy 
supervisor: supervisor 
sandra: sandra 
jeremiah: jeremiah 
llc: llc 
iloveu: iloveu 
quality: quality 
insight: insight 
betrayal: betrayal 
viral: viral 
ya: ya 
million: millions 
ray: ray 
always: always 
expand: expand 
adam: adam 
vino: vino 
ake: ake 
orleans: orleans 
recording: recording 
jae: jae 
feel: feel 
pain: pain 
callejero: callejero 
christopher: christopher 
shawty: shawty 
johnson: johnson 
designer: designer 
episode: episode 
portuguese: portuguese 
decorator: decorator 
toli: toli 
kitty: kitty 
repeating: repeating 
christian: christian 
dark: dark 
track: track 
pruss: pruss 
ev: ev 
marcus: marcus 
confirmed: confirmed 
love: love 
lie: lies 
hit: hit 
heartfelt: heartfelt 
peermusic: peermusic 
trapmoneybenny: trapmoneybenny 
aqua: aqua 
fagon: fagon 
nichols: nichols 
publishing: publishing 
work: work 
set: set 
covert: covert 
scorpion: scorpion 
adele: adele 
date: date 
food: food 
ex: ex 
wraith: wraith 
c: c 
rodriguez: rodriguez 
reservoir: reservoir 
adrienne: adrienne 
skit: skit 
megamix: megamix 
dent: dents 
hugo: hugo 
fast: fast 
cash: cash 
tarek: tarek 
broker: broker 
march: march 
daniel: daniel 
mashup: mashup 
weak: weak 
ziegler: ziegler 
h: h 
individual: individual 
michel: michel 
mar: mar 
diggin: diggin 
iman: iman 
certification: certifications 
cause: cause 
troy: troy 
lp: lp 
smoke: smoke 
four: four 
jaded: jaded 
crown: crown 
riley: riley 
libro: libro 
know: know 
coordinator: coordinator 
personal: personal 
ghoss: ghoss 
gamble: gamble 
transcription: transcription 
bracy: bracy 
chart: charts 
might: might 
pedl: pedl 
gaat: gaat 
honest: honest 
yeah: yeah 
applebaum: applebaum 
leah: leah 
aiono: aiono 
turnin: turnin 
jones: jones 
brian: brian 
canadiana: canadiana 
socan: socan 
waiting: waiting 
warner: warner 
kim: kim 
record: records 
vich: vich 
cimorelli: cimorelli 
sing: sing 
finesse: finesse 
cameltoe: cameltoe 
music: music 
miss: miss 
l: l 
really: really 
clinton: clinton 
global: global 
arriola: arriola 
chillin: chillin 
br: br 
travis: travis 
lola: lola 
question: question 
producer: producer 
magic: magic 
drop: drop 
gotta: gotta 
kb: kb 
espa: espa 
shop: shop 
produced: produced 
barnhart: barnhart 
learn: learn 
deserved: deserved 
gordon: gordon 
verse: verse 
tv: tv 
schultz: schultz 
earned: earned 
anthony: anthony 
young: young 
protoons: protoons 
executive: executive 
fantasy: fantasy 
st: st 
duran: duran 
teezy: teezy 
dj: dj 
patterson: patterson 
scholar: scholars 
drake: drake 
jt: jt 
girsat: girsat 
fire: fire 
dot: dot 
hub: hub 
van: van 
hmu: hmu 
myles: myles 
dro: dro 
design: design 
interpolation: interpolations 
caraimann: caraimann 
keke: keke 
guess: guess 
gadget: gadget 
as: ass 
anna: anna 
version: version 
scary: scary 
entertainment: entertainment 
myers: myers 
shiggy: shiggy 
herbalicious: herbalicious 
net: net 
ynbkasv: ynbkasv 
pochi: pochi 
umpg: umpg 
kat: kat 
abramus: abramus 
special: special 
