damn: damn 
blooper: bloopers 
talk: talk 
degree: degrees 
italic: italics 
woo: woo 
chorus: chorus 
section: section 
represents: represents 
girl: girl girls 
nobody: nobody 
let: let 
nigga: nigga 
good: good 
remixes: remixes 
pasqu: pasqu 
ready: ready 
movie: movie 
collection: collection 
use: use 
woman: woman women 
heard: heard 
corp: corp 
lyric: lyrics lyric 
bad: bad 
give: give 
outro: outro 
richie: richie 
chief: chief 
put: put 
information: information 
rapper: rapper 
spice: spice 
boy: boy 
thicc: thicc 
portland: portland 
includes: includes 
factory: factory 
type: types type 
w: w 
world: world 
holding: holdings 
shut: shut 
making: making 
oh: oh 
thug: thug 
sunday: sundays 
v: v 
filmmaker: filmmaker 
baby: baby 
urgent: urgent 
indica: indica 
wanna: wanna 
beyonc: beyonc 
alex: alex 
privacy: privacy 
artist: artists 
want: want 
pad: pads 
ayy: ayy 
icky: icky 
directed: directed 
writing: writing 
bout: bout 
loved: loved 
beat: beats beat 
tarantino: tarantino 
effort: effort 
another: another 
run: run 
answer: answer 
intention: intentions 
share: share 
k: k 
guideline: guidelines 
name: name 
check: check 
song: song songs 
credit: credits 
heebiejeebies: heebiejeebies 
man: man 
republic: republic 
crasher: crashers 
even: even 
broccoli: broccoli 
engineer: engineer 
described: described 
dime: dime 
post: post 
freaky: freaky 
eat: eat 
money: money 
keef: keef 
comment: comment comments 
wrote: wrote 
commentary: commentary 
frequency: frequency 
contributor: contributor contributors 
read: read 
word: word 
lil: lil 
underground: underground 
part: parts part 
met: met 
header: headers 
background: background 
ask: ask 
written: written 
performance: performance performances 
format: format 
scene: scenes 
vocalist: vocalists 
ah: ah 
developer: developers 
probably: probably 
jean: jean 
swerved: swerved 
horoscope: horoscope 
remix: remix 
mixing: mixing 
view: view 
musical: musical 
visit: visit 
gory: gory 
created: created 
shit: shit 
p: p 
ooh: ooh 
see: see 
uh: uh 
gabriel: gabriel 
broken: broken 
different: different 
pro: pro 
wacko: wacko 
vida: vida 
video: videos video 
aha: aha 
featured: featured 
tag: tags 
label: label 
hero: hero 
ascap: ascap 
got: got 
coast: coast 
timmy: timmy 
seventeen: seventeen 
release: release releases 
b: b 
right: rights 
group: group 
would: would 
hear: hear 
bmi: bmi 
sticky: sticky 
intro: intro 
raffe: raffe 
x: x 
one: one 
transcriber: transcribers 
night: night 
billie: billie 
popp: popp 
simmering: simmering 
via: via 
policy: policy 
knee: knee 
publisher: publisher 
future: future 
influence: influence 
tamerlane: tamerlane 
etc: etc 
barry: barry 
sell: sell 
foot: feet 
lane: lane 
caroline: caroline 
annotation: annotation 
perform: perform 
listen: listen 
bet: bet 
amin: amin 
along: along 
woah: woah 
outkast: outkast 
push: push 
genius: genius 
visual: visual 
sample: samples sample 
agitated: agitated 
press: press 
club: club 
performed: performed 
rap: rap 
turf: turf 
thess: thess 
born: born 
reference: references 
programmer: programmer 
thick: thick 
gon: gon 
forever: forever 
else: else 
u: u us 
verified: verified 
n: n 
safe: safe 
g: g 
scurred: scurred 
show: show 
knowledge: knowledge 
genuine: genuine 
wedding: wedding 
hedgehog: hedgehog 
west: west 
death: death 
line: lines 
goddamn: goddamn 
licensing: licensing 
j: j 
life: life 
ky: ky 
piece: piece 
true: true 
say: say 
pablo: pablo 
forum: forum 
lookin: lookin 
tonight: tonight 
quentin: quentin 
said: said 
advertise: advertise 
add: add 
saying: saying 
nikolaus: nikolaus 
specific: specific 
lmsyd: lmsyd 
understand: understand 
guide: guide 
drip: drip 
break: break 
hold: holds 
promote: promote 
job: jobs 
copyright: copyright 
mainstream: mainstream 
biggest: biggest 
bold: bold 
f: f 
appears: appears 
contact: contact 
ml: ml 
also: also 
get: get 
runnin: runnin 
mean: mean 
sex: sex 
chee: chee 
lit: lit 
fact: facts 
fake: fake 
cancel: cancel 
trap: trap 
z: z 
singe: singe 
holy: holy 
mastering: mastering 
new: new 
extremely: extremely 
vevodscvr: vevodscvr 
made: made 
nah: nah 
meagan: meagan 
term: terms 
thought: thought 
clever: clever 
black: black 
modern: modern 
decaf: decaf 
interpolate: interpolate 
general: general 
god: god 
keep: keep 
la: la 
blow: blow 
embed: embed 
first: first 
thang: thang 
universal: universal 
ft: ft 
time: time 
banana: banana 
fine: fine 
hot: hot 
ultimate: ultimate 
william: william 
lame: lame 
receive: receive 
like: like 
distinguish: distinguish 
stfu: stfu 
burn: burns 
cover: covers 
westside: westside 
tall: tall 
fuck: fuck 
dababy: dababy 
slide: slide 
source: source 
sign: sign 
q: q 
day: day 
pop: pop 
r: r 
done: done 
pipe: pipe 
llc: llc 
insight: insight 
viral: viral 
e: e 
definitely: definitely 
expand: expand 
hell: hell 
great: great 
shawty: shawty 
kitty: kitty 
repeating: repeating 
track: track 
hopefully: hopefully 
love: love 
hit: hit 
veggie: veggies 
schuman: schuman 
publishing: publishing 
amine: amine 
date: date 
handful: handful 
namechecked: namechecked 
c: c 
march: march 
mashup: mashup 
h: h 
individual: individual 
naw: naw 
certification: certifications 
cause: cause 
know: know 
perfect: perfect 
personal: personal 
kinnes: kinnes 
transcription: transcription 
chart: charts 
might: might 
mighty: mighty 
pre: pre 
honest: honest 
aiono: aiono 
brian: brian 
warner: warner 
vocal: vocals 
record: records 
beach: beach 
music: music 
l: l 
rose: roses 
really: really 
divine: divine 
live: live 
question: question 
producer: producer 
killa: killa 
drop: drop 
yellow: yellow 
shop: shop 
produced: produced 
learn: learn 
dakota: dakota 
verse: verse 
editing: editing 
young: young 
recorded: recorded 
scholar: scholars 
blind: blinds 
viva: viva 
guess: guess 
yvng: yvng 
audio: audio 
