ussobi: ussobi 
headband: headband 
italic: italics 
chauncey: chauncey 
confession: confessions 
around: around 
chorus: chorus 
thought: thoughts 
note: note 
still: still 
section: section 
time: times time 
nobody: nobody 
mannequin: mannequins mannequin 
let: let 
chazer: chazer 
nigga: nigga 
banter: banter 
anything: anything 
attracted: attracted 
semi: semi 
lapkins: lapkins 
loathe: loathe 
good: good 
bare: bare 
prayer: prayer 
remixes: remixes 
little: little 
inadequate: inadequate 
dracula: dracula 
bannigans: bannigans 
merkules: merkules 
released: released 
ready: ready 
collection: collection 
insane: insane 
liga: liga 
nitin: nitin 
use: use 
month: month 
lyric: lyrics lyric 
bad: bad 
suicide: suicide 
uribe: uribe 
outro: outro 
hova: hova 
stop: stop 
cryptic: cryptic 
information: information 
rapper: rapper rappers 
cypher: cypher 
boy: boy 
speds: speds 
shady: shady 
kid: kids kid 
crazy: crazy 
w: w 
six: six 
world: world 
holding: holdings 
pxz: pxz 
oh: oh 
goin: goin 
v: v 
baby: baby 
ha: ha 
shroom: shroom 
third: third 
back: back 
mouth: mouth 
wanna: wanna 
joshter: joshter 
beyonc: beyonc 
yungmex: yungmex 
giving: giving 
prod: prod 
scrud: scrud 
attackin: attackin 
artist: artists 
want: want 
yes: yes 
jonathon: jonathon 
privacy: privacy 
write: write 
sheep: sheep 
twisted: twisted 
boogie: boogie 
rap: raps rap 
bout: bout 
loved: loved 
commando: commando 
go: go goes 
rainy: rainy 
ramen: ramen 
aware: aware 
joyner: joyner 
another: another 
juice: juice 
dick: dick 
eviri: eviri 
session: sessions 
answer: answer 
upside: upside 
thinkin: thinkin 
roll: roll 
share: share 
yb: yb 
tihom: tihom 
k: k 
tailbone: tailbone 
tim: tim 
think: think 
wisdom: wisdom 
co: co 
guideline: guidelines 
name: name 
toe: toes 
check: check 
song: song songs 
credit: credits 
exaggeration: exaggeration 
homicide: homicide 
man: man 
chantin: chantin 
rod: rod 
gonna: gonna 
ethos: ethos 
even: even 
engineer: engineer 
mill: mill 
thing: thing 
dad: dad 
rich: rich 
fucker: fuckers 
liar: liar 
assert: assert 
ric: ric 
legendary: legendary 
eat: eat 
money: money 
everything: everything 
scatterin: scatterin 
songview: songview 
genocide: genocide 
hardcore: hardcore 
comment: comment comments 
wrote: wrote 
chapstick: chapstick 
nocide: nocide 
cell: cell 
contributor: contributor contributors 
assassin: assassin 
greatest: greatest 
read: read 
standin: standin 
lil: lil 
dillan: dillan 
sleep: sleep 
english: english 
health: health 
free: free 
part: parts part 
fingerless: fingerless 
panickin: panickin 
janet: janet 
header: headers 
ask: ask 
written: written 
performance: performance 
va: va 
format: format 
schoegje: schoegje 
vocalist: vocalists 
developer: developers 
illest: illest 
non: non 
villainous: villainous 
jean: jean 
lyricism: lyricism 
rapid: rapid 
leopardi: leopardi 
ballin: ballin 
phonographic: phonographic 
stiff: stiff 
alive: alive 
director: director 
bandana: bandana 
remix: remix 
die: die 
pull: pull 
wrld: wrld 
hug: hug 
rk: rk 
mixing: mixing 
jesse: jesse 
view: view 
limp: limp 
mc: mcs 
papkins: papkins 
que: que 
visit: visit 
hanna: hanna 
campbell: campbell 
musical: musical 
though: though 
moth: moth 
created: created 
billboard: billboard 
shit: shit 
game: game 
batterin: batterin 
cocaine: cocaine 
jam: jam 
detroit: detroit 
head: head 
p: p 
behemoth: behemoth 
slump: slumps 
see: see 
crucified: crucified 
rennie: rennie 
glove: gloves 
meant: meant 
call: call 
dax: dax 
breakin: breakin 
reef: reeves 
broken: broken 
different: different 
desire: desire 
feelin: feelin 
kazanika: kazanika 
shot: shot 
vida: vida 
maybe: maybe 
floorboard: floorboards 
red: red 
knuckle: knuckle 
video: videos video 
nantucket: nantucket 
featured: featured 
cool: cool 
album: album 
tag: tags 
pretty: pretty 
label: label 
parody: parody 
hol: hol 
matter: matter 
gawne: gawne 
ascap: ascap 
cannabis: cannabis 
collaborate: collaborate 
clickbait: clickbait 
takin: takin 
got: got 
baytee: baytee 
coast: coast 
flamminababbitapannitajampkin: flamminababbitapannitajampkin 
rhyme: rhyme 
type: type 
release: release 
b: b 
flair: flair 
bustin: bustin 
buck: buck 
right: rights 
jigga: jigga 
bitch: bitches 
dripper: dripper 
anilyst: anilyst 
group: group 
nowhere: nowhere 
getting: getting 
dobermann: dobermann 
would: would 
hear: hear 
bmi: bmi 
intro: intro 
gusta: gusta 
randhawa: randhawa 
glexnos: glexnos 
x: x 
one: one 
transcriber: transcribers 
candle: candle 
scru: scru 
tourin: tourin 
roof: roof 
luis: luis 
policy: policy 
singular: singular 
washed: washed 
publisher: publisher 
slim: slim 
production: productions 
etc: etc 
oth: oth 
could: could 
sell: sell 
took: took 
ford: ford 
rover: rover 
trigger: trigger triggers 
sub: sub 
snap: snap 
bobby: bobby 
used: used 
annotation: annotation 
perform: perform 
listen: listen 
air: air 
relevant: relevant 
hide: hide 
best: best 
polish: polish 
genius: genius 
figured: figured 
dakira: dakira 
lost: lost 
opponent: opponents 
mass: mass 
featuring: featuring 
people: people 
standup: standup 
sample: samples sample 
day: days 
press: press 
test: test 
flappin: flappin 
freestyle: freestyle 
mind: mind 
fagkii: fagkii 
sound: sound sounds 
pt: pt 
title: title 
cab: cab 
wipe: wipe 
latino: latino 
gon: gon 
else: else 
flow: flows 
vigil: vigil 
lyrically: lyrically 
u: u us 
starin: starin 
fam: fam 
mama: mama 
verified: verified 
n: n 
g: g 
tired: tired 
face: face 
phone: phone 
show: show 
vol: vol 
afraid: afraid 
stephen: stephens 
knowledge: knowledge 
every: every 
artwork: artwork 
make: make 
shared: shared 
godzilla: godzilla 
west: west 
otherwise: otherwise 
death: death 
bar: bars 
line: lines 
dabra: dabra 
goddamn: goddamn 
licensing: licensing 
rabies: rabies 
pada: pada 
j: j 
throw: throw 
someone: someone 
italiane: italiane 
chapki: chapki 
pump: pump 
hitter: hitters 
killin: killin 
awesome: awesome 
say: say 
forum: forum 
lookin: lookin 
detractor: detractors 
said: said 
mellow: mellow 
dikulz: dikulz 
solomon: solomon 
advertise: advertise 
many: many 
bathing: bathing 
additional: additional 
lyrical: lyrical 
add: add 
porsche: porsche 
smacked: smacked 
bregma: bregma 
understand: understand 
guide: guide 
history: history 
donnell: donnell 
traduzione: traduzione 
deal: deal 
bill: bills 
son: son 
sight: sight 
please: please 
derringer: derringer 
harrison: harrison 
twitter: twitter 
blood: blood 
school: school 
foul: foul 
promote: promote 
hip: hip 
blitz: blitz 
unloadin: unloadin 
copyright: copyright 
job: jobs 
biggest: biggest 
squint: squints 
bold: bold 
automatic: automatic 
plan: plan 
umaczenie: umaczenie 
f: f 
handkerchief: handkerchief 
lucas: lucas 
dammit: dammit 
contact: contact 
em: em 
turkish: turkish 
lemonade: lemonade 
instead: instead 
ml: ml 
recording: recordings recording 
compare: compare 
also: also 
distributor: distributor 
get: get 
came: came 
umaczenia: umaczenia 
played: played 
polski: polski 
kill: kill 
translation: translations translation 
slow: slow 
hardknocktv: hardknocktv 
wannabe: wannabe 
lackin: lackin 
ego: ego 
abraca: abraca 
ball: balls 
body: body 
homered: homered 
nicki: nicki 
comin: comin 
fact: facts 
resto: resto 
def: def 
chicken: chicken 
chris: chris 
cancel: cancel 
trap: trap 
keanu: keanu 
z: z 
high: high 
steal: steal 
resurgence: resurgence 
limitless: limitless 
mode: mode 
murdering: murdering 
way: way 
look: look 
fanagans: fanagans 
sir: sir 
quickly: quickly 
elia: elia 
spillin: spillin 
self: self 
vent: vent 
plannin: plannin 
nah: nah 
callin: callin 
hahahahahaha: hahahahahaha 
term: terms 
east: east 
polskie: polskie 
cabana: cabana 
hoe: hoes 
bringin: bringin 
hair: hair 
blana: blana 
interpolate: interpolate 
whopper: whopper 
bear: bear 
wheel: wheel 
bana: bana 
icy: icy 
sit: sit 
james: james 
hop: hop 
keep: keep 
la: la 
spratt: spratt 
trying: trying 
embed: embed 
beast: beast 
universal: universal 
exhibit: exhibits 
ft: ft 
visionary: visionary 
rhymed: rhymed 
three: three 
hot: hot 
gas: gas 
farsi: farsi 
well: well 
ultimate: ultimate 
lame: lame 
attack: attack 
recognized: recognized 
receive: receive 
like: like 
distinguish: distinguish 
makin: makin 
impress: impress 
westside: westside 
bapkin: bapkin 
yankee: yankees 
crow: crow 
dangerous: dangerous 
logpog: logpog 
fuck: fuck 
chika: chika 
redpartyscene: redpartyscene 
source: source 
leave: leave 
trapped: trapped 
sign: sign 
play: plays 
q: q 
millionaire: millionaire 
stay: stay 
bailard: bailard 
reel: reel 
r: r 
place: place 
favorite: favorite 
done: done 
vibe: vibe 
gun: gun 
minute: minutes 
industry: industry 
jig: jig 
llc: llc 
official: official 
kazana: kazana 
seems: seems 
insight: insight 
deserve: deserve 
caterpillar: caterpillar 
ya: ya 
e: e 
expand: expand 
platypus: platypus 
big: big 
hell: hell 
napkin: napkins 
leavin: leavin 
larese: larese 
designer: designer 
terrier: terrier 
may: may 
smokey: smokey 
repeating: repeating 
track: track 
love: love 
motherfucker: motherfuckers 
hit: hit 
crypt: crypt 
find: find 
hold: hold 
pardon: pardon 
sandlot: sandlot 
unreleased: unreleased 
work: work 
iii: iii 
sam: sam 
date: date 
girl: girls 
c: c 
fast: fast 
jeremy: jeremy 
squadeca: squadeca 
wazer: wazer 
logic: logic 
dog: dog 
chevere: chevere 
interview: interview 
h: h 
individual: individual 
certification: certifications 
cause: cause 
lull: lull 
single: single 
smoke: smoke 
internet: internet 
itsunknownmf: itsunknownmf 
everybody: everybody 
using: using 
duct: duct 
know: know 
personal: personal 
minaj: minaj 
innovation: innovation 
eminem: eminem 
transcription: transcription 
chart: charts 
might: might 
dethroned: dethroned 
malachythedemon: malachythedemon 
glexkii: glexkii 
repo: repo 
addict: addict 
subject: subject 
yeah: yeah 
dude: dude 
stamen: stamina 
dis: diss 
foamin: foamin 
bit: bit 
full: full 
catch: catch 
vocal: vocals 
urbanist: urbanist 
anybody: anybody 
thud: thud 
dare: dare 
italian: italian 
music: music 
l: l 
really: really 
question: question 
clothes: clothes 
producer: producer 
bam: bam 
isi: isis 
drop: drop 
gotta: gotta 
shop: shop 
feeling: feeling 
lady: lady 
produced: produced 
learn: learn 
toter: toters 
phoenixgold: phoenixgold 
spit: spit 
king: king 
decade: decades 
murder: murder 
flame: flame 
verse: verse 
rare: rare 
young: young 
italiana: italiana 
usin: usin 
scholar: scholars 
fire: fire 
viva: viva 
fuckin: fuckin 
interpolation: interpolations 
nowadays: nowadays 
divorcin: divorcin 
scratch: scratch 
swisher: swisher 
as: ass 
ka: ka 
traduzioni: traduzioni 
jay: jay 
beat: beat 
italiano: italiano 
ill: ill 
prodbyword: prodbyword 
