guy: guys 
bernard: bernard 
damn: damn 
tradu: tradu 
italic: italics 
bitch: bitch bitches 
looked: looked 
shotgun: shotgun 
bread: bread 
terry: terry 
chorus: chorus 
redo: redo 
section: section 
mo: mo 
girl: girl girls 
ant: ant 
cheated: cheated 
dreigonix: dreigonix 
pr: prs 
stealing: stealing 
vers: vers 
showed: showed 
deutsch: deutsch 
credimi: credimi 
abi: abi 
remixes: remixes 
buck: bucks 
little: little 
gribin: gribin 
released: released 
traductions: traductions 
collection: collection 
apronta: apronta 
butthole: butthole 
craig: craig 
tell: tell 
use: use 
queezy: queezy 
svenska: svenska 
bird: bird 
juan: juan 
lyric: lyrics lyric 
bad: bad 
olimac: olimac 
give: give 
ttning: ttning 
wise: wise 
heavy: heavy 
athletic: athletic 
put: put 
information: information 
boy: boy 
w: w 
pikuli: pikuli 
uzi: uzi 
world: world 
holding: holdings 
jab: jabs 
subsequently: subsequently 
de: de 
alkpote: alkpote 
traduction: traduction 
robb: robb 
v: v vs 
bother: bother 
tampa: tampa 
schneewei: schneewei 
baby: baby 
vlestatt: vlestatt 
hearing: hearing 
actress: actress 
cardi: cardi 
wanna: wanna 
joshter: joshter 
retch: retch 
tankhead: tankhead 
giving: giving 
ban: bans 
concord: concord 
acrylo: acrylo 
privacy: privacy 
gummo: gummo 
want: want 
artist: artists artist 
parent: parents 
ayy: ayy 
ukrainian: ukrainian 
sheep: sheep 
diabate: diabate 
makeup: makeup 
uma: uma 
loved: loved 
go: go 
beat: beats beat 
prompting: prompting 
miami: miami 
knew: knew 
teelawst: teelawst 
rajae: rajae 
xxxtentaci: xxxtentaci 
otro: otro 
vloggeri: vloggeri 
humble: humble 
ubem: ubem 
dick: dick 
eviri: eviri 
answer: answer 
soundcloud: soundcloud 
gravy: gravy 
share: share 
ru: ru 
fallen: fallen 
gang: gang 
rip: rip 
avec: avec 
comethazine: comethazine 
drast: drast 
second: second 
never: never 
kmt: kmt 
fl: fl 
skeet: skeet 
kvneki: kvneki 
k: k 
co: co 
guideline: guidelines 
name: name 
gay: gay 
check: check 
opps: opps 
song: song songs 
mics: mics 
credit: credits credit 
impel: impel 
osx: osx 
megamashup: megamashup 
aulnay: aulnay 
cum: cum 
deutsche: deutsche 
notgrass: notgrass 
admitted: admitted 
man: man mans 
going: going 
stanley: stanley 
even: even 
sybyr: sybyr 
mill: mill 
versus: versus 
camera: camera 
casey: casey 
battle: battle 
liar: liar 
viado: viado 
ziliax: ziliax 
hole: hole 
previewed: previewed 
login: login 
ii: ii 
songview: songview 
comment: comment comments 
hardcore: hardcore 
mental: mental 
operator: operator 
cg: cg 
commentary: commentary 
cria: cria 
looking: looking 
wan: wan 
auceking: auceking 
wii: wii 
contributor: contributor contributors 
actually: actually 
rojas: rojas 
yung: yung 
duval: duval 
read: read 
lil: lil 
xxx: xxx 
slump: slump 
distort: distort 
riaa: riaa 
part: parts part 
free: free 
header: headers 
roach: roach 
performance: performance 
ask: ask 
stuff: stuff 
written: written 
format: format 
haze: haze 
valentine: valentine 
vocalist: vocalists 
developer: developers 
style: styles 
eight: eight 
riksm: riksm 
elevator: elevator 
dyyo: dyyo 
emo: emo 
introduced: introduced 
bokm: bokm 
haha: haha 
phonographic: phonographic 
ine: ine 
september: september 
director: director 
garfo: garfo 
remix: remix 
die: die 
bg: bg 
eventually: eventually 
il: il 
rk: rk 
view: view 
musical: musical 
dead: dead 
visit: visit 
though: though 
nutella: nutella 
created: created 
billboard: billboard 
shit: shit 
game: game 
illeoo: illeoo 
throat: throat 
studio: studio 
tomasz: tomasz 
head: head 
xxxtentacion: xxxtentacion 
p: p 
mortik: mortik 
norwegian: norwegian 
dax: dax 
medium: media 
platz: platz 
broken: broken 
different: different 
legal: legal 
stunt: stunt 
paz: paz 
jup: jup 
kizaru: kizaru 
bright: bright 
star: star 
rock: rock 
red: red 
e: es e 
poutana: poutana 
video: videos video 
pant: pants 
pussy: pussy 
xaev: xaev 
casablanca: casablanca 
featured: featured 
flow: flow 
tag: tags 
vibe: vibes 
grant: grants 
pxxxano: pxxxano 
label: label 
mc: mc 
remicks: remicks 
parody: parody 
mascka: mascka 
ascap: ascap 
al: al 
denied: denied 
funnybone: funnybone 
got: got 
lucid: lucid 
type: type 
lashawnna: lashawnna 
ovejas: ovejas 
marvin: marvin 
release: release 
b: b 
lean: lean 
gaybe: gaybe 
di: di 
sounding: sounding 
right: rights 
gangster: gangster 
damndef: damndef 
group: group 
forehead: forehead 
tommy: tommy 
chick: chick 
kgoldn: kgoldn 
would: would 
fucked: fucked 
bmi: bmi 
together: together 
fukkit: fukkit 
intro: intro 
french: french 
svensk: svensk 
jiorgi: jiorgi 
x: x 
one: one 
patrick: patrick 
dryno: dryno 
transcriber: transcribers 
smurt: smurt 
received: received 
ksubis: ksubis 
via: via 
policy: policy 
publisher: publisher 
future: future 
kendrick: kendrick 
ten: ten 
dk: dk 
etc: etc 
sell: sell 
friend: friends 
creative: creative 
fran: fran 
tongue: tongue 
took: took 
portugu: portugu 
cant: cant 
foot: feet 
crumb: crumb 
brussel: brussel 
frustration: frustration 
luv: luv 
annotation: annotation 
mob: mob 
mega: mega 
szela: szela 
company: company 
daymanoursavior: daymanoursavior 
bank: bank 
jail: jail 
nigga: niggas 
kin: kin 
ecko: ecko 
polish: polish 
best: best 
ben: ben 
david: david 
gimbal: gimbal 
genius: genius 
malandro: malandro 
ix: ix 
brico: brico 
metal: metal 
saiko: saiko 
amra: amra 
lost: lost 
roboi: roboi 
sample: samples sample 
anymore: anymore 
preview: preview 
jpegmafia: jpegmafia 
blue: blue 
oversettelse: oversettelse 
press: press 
russian: russian 
gallego: gallego 
freestyle: freestyle 
slava: slava 
mind: mind 
rap: rap 
sound: sound 
pt: pt 
hotbox: hotbox 
bersetzungen: bersetzungen 
favela: favela 
boof: boof 
similarity: similarities 
forever: forever 
jahseh: jahseh 
surgery: surgery 
u: u us 
verified: verified 
n: n 
vro: vro 
network: network 
hearns: hearns 
voots: voots 
rmx: rmx 
g: g 
face: face 
mystikz: mystikz 
help: help 
show: show 
knowledge: knowledge 
every: every 
ghostraps: ghostraps 
space: space 
scum: scum 
talking: talking 
godzilla: godzilla 
shout: shouts 
orsons: orsons 
skorn: skorn 
death: death 
obladaet: obladaet 
krzysztof: krzysztof 
line: lines 
brasil: brasil 
licensing: licensing 
j: j 
corbin: corbin 
assistant: assistant 
german: german 
limsa: limsa 
yo: yo 
chart: chart charts 
surge: surge 
submarine: submarine 
choose: choose 
fred: fred 
jmp: jmp 
poetic: poetic 
edited: edited 
ol: ol 
forum: forum 
late: late 
respond: respond 
traducciones: traducciones 
xen: xen 
said: said 
curly: curly 
advertise: advertise 
kononowicz: kononowicz 
ai: aises ais 
editor: editor 
campa: campa 
add: add 
runescape: runescape 
saying: saying 
nara: nara 
swedish: swedish 
oul: oul 
understand: understand 
florida: florida 
guide: guide 
rather: rather 
extreme: extreme 
inzei: inzei 
freex: freex 
violent: violent 
dirrt: dirrt 
son: son 
skase: skase 
gorka: gorka 
royalty: royalty royalties 
promote: promote 
hip: hip 
kobalt: kobalt 
incel: incel 
la: las 
copyright: copyright 
job: jobs 
biggest: biggest 
bold: bold 
f: f 
umaczenie: umaczenie 
photography: photography 
cover: cover covers 
crib: crib 
toe: toe 
contact: contact 
vaata: vaata 
situation: situation 
em: em 
turkish: turkish 
similar: similar 
ml: ml 
brought: brought 
skinner: skinner 
mask: mask 
rapping: rapping 
wahl: wahl 
production: production 
ita: ita 
also: also 
kusorare: kusorare 
distributor: distributor 
get: get 
came: came 
alberdi: alberdi 
umaczenia: umaczenia 
management: management 
polski: polski 
slovak: slovak 
kill: kill 
translation: translations translation 
traducci: traducci 
sitting: sitting 
hilfiger: hilfiger 
bersetzung: bersetzung 
gigalow: gigalow 
white: white 
kor: kor 
norsk: norsk 
fact: facts 
dutch: dutch 
interlude: interlude 
pagami: pagami 
kamiyada: kamiyada 
cancel: cancel 
squint: squint 
meek: meek 
trap: trap 
florian: florian 
playthatboizay: playthatboizay 
z: z 
tweeted: tweeted 
controversial: controversial 
come: come 
steal: steal 
solar: solar 
katerine: katerine 
fuzil: fuzil 
new: new 
bego: bego 
look: look 
made: made 
top: top 
teanna: teanna 
january: january 
pulse: pulse 
booth: booth 
mix: mix 
term: terms 
envole: envole 
popularity: popularity 
streaming: streaming 
polskie: polskie 
hair: hair 
empire: empire 
pancreas: pancreas 
lord: lord 
joey: joey 
amen: amen 
interpolate: interpolate 
whopper: whopper 
latinautor: latinautor 
starbucks: starbucks 
mixtape: mixtape 
mala: mala 
god: god 
hop: hop 
keep: keep 
rizas: rizas 
rocking: rocking 
bounce: bounce 
sertralina: sertralina 
casting: casting 
kick: kick 
embed: embed 
aise: aise 
whole: whole 
kmr: kmr 
first: first 
luckhaos: luckhaos 
universal: universal 
ft: ft 
cks: cks 
last: last 
donald: donald 
digital: digital 
slit: slit 
starz: starz 
main: main 
slipknot: slipknot 
hot: hot 
three: three 
luxor: luxor 
missing: missing 
ultimate: ultimate 
wider: wider 
kaver: kaver 
like: like 
danielle: danielle 
distinguish: distinguish 
milo: milo 
hillel: hillel 
super: super 
better: better 
dire: dire 
cmrra: cmrra 
breakdown: breakdown 
misfit: misfit 
follow: follow 
fuck: fuck 
pound: pound 
wrist: wrist 
went: went 
source: source 
shook: shook 
bath: bath 
sign: sign 
flyingkitty: flyingkitty 
mii: mii 
play: plays 
tre: tre 
pandemic: pandemic 
gave: gave 
q: q 
day: day 
r: r 
revenge: revenge 
kanjass: kanjass 
done: done 
gun: gun 
minute: minutes 
origin: origin 
spanish: spanish 
lomepal: lomepal 
pipe: pipe 
smith: smith 
bass: bass 
dia: dia 
llc: llc 
taky: taky 
jimmy: jimmy 
quality: quality 
nikolai: nikolai 
milchman: milchman 
tape: tape 
insight: insight 
chloe: chloe 
roscomnadzor: roscomnadzor 
expand: expand 
sheldon: sheldon 
voot: voot 
big: big 
fama: fama 
orleans: orleans 
natalia: natalia 
metth: metth 
yah: yah 
terka: terka 
already: already 
may: may 
repeating: repeating 
premiere: premiere 
track: track 
change: changes 
sport: sports 
sexy: sexy 
love: love 
crypt: crypt 
find: find 
mueren: mueren 
meme: meme 
jrkellyrocks: jrkellyrocks 
publishing: publishing 
voodoo: voodoo 
work: work 
sam: sam 
grc: grc 
miller: miller 
date: date 
send: send 
xxxpennisandalsodickieandball: xxxpennisandalsodickieandball 
c: c 
sadboy: sadboy 
lullaby: lullaby 
ak: ak 
placed: placed 
dillon: dillon 
straight: straight 
ski: ski 
dog: dog 
h: h 
kay: kay 
individual: individual 
scsp: scsp 
oxxxymiron: oxxxymiron 
service: services 
soil: soil 
marteria: marteria 
certification: certifications 
pagame: pagame 
chelsea: chelsea 
smoke: smoke 
eric: eric 
frey: frey 
coordinator: coordinator 
tr: tr 
perfect: perfect 
personal: personal 
transcription: transcription 
might: might 
spritethekidd: spritethekidd 
huff: huff 
syphilis: syphilis 
idea: idea 
greenlight: greenlight 
abiat: abiat 
staying: staying 
mr: mr 
carlos: carlos 
meh: meh 
diddy: diddy 
brother: brother 
band: bands 
record: records 
parkinson: parkinson 
rael: rael 
music: music 
l: l 
bofill: bofill 
really: really 
flop: flop 
bratz: bratz 
resval: resval 
kid: kid 
pibe: pibe 
question: question 
producer: producer 
magic: magic 
riot: riot 
giggs: giggs 
drop: drop 
lixo: lixo 
shop: shop 
espa: espa 
produced: produced 
learn: learn 
remy: remy 
king: king 
mormon: mormon 
prxjek: prxjek 
decided: decided 
verse: verse 
kip: kip 
young: young 
recorded: recorded 
scholar: scholars 
deathwing: deathwing 
swenz: swenz 
drake: drake 
picture: picture 
december: december 
kodama: kodama 
par: par 
mixx: mixx 
ahmed: ahmed 
version: version 
brick: brick 
meu: meu 
audio: audio 
jay: jay 
kp: kpss 
