damn: damn 
vent: vents 
junior: junior 
penitentiary: penitentiary 
talk: talk 
lexpair: lexpair 
turkey: turkey 
italic: italics 
bitch: bitch bitches 
around: around 
chorus: chorus 
ro: ro 
brenda: brenda 
still: still 
burn: burn 
section: section 
totin: totin 
motherfuckas: motherfuckas 
retaliated: retaliated 
mary: mary 
nobody: nobody 
kiss: kiss 
let: let 
plenty: plenty 
cocked: cocked 
docta: docta 
nigga: nigga niggas 
luccas: luccas 
miniminter: miniminter 
pas: pass 
couch: couch 
hate: hate 
punk: punks 
noted: noted 
bless: bless 
remixes: remixes 
mash: mash 
cj: cj 
little: little 
locked: locked 
softer: softer 
te: te 
imaginary: imaginary 
pollutin: pollutin 
released: released 
killuminati: killuminati 
briggs: briggs 
ready: ready 
rez: rez 
traductions: traductions 
collection: collection 
clout: clout 
tell: tell 
poetik: poetik 
use: use 
queezy: queezy 
latinautorperf: latinautorperf 
heard: heard 
corp: corp 
lyric: lyrics lyric 
mistah: mistah 
bad: bad 
deep: deep 
outro: outro 
chief: chief 
put: put 
information: information 
demo: demo 
tear: tears 
epmd: epmd 
cypher: cypher 
rapper: rapper rappers 
badass: badass 
spice: spice 
boy: boy boys 
mia: mia 
explicit: explicit 
hype: hype 
kid: kids 
w: w 
crazy: crazy 
world: world 
shivam: shivam 
jab: jabs 
holding: holdings 
de: de 
traduction: traduction 
thug: thug 
oh: oh 
threat: threats 
pinche: pinche 
v: v vs 
baby: baby 
cold: cold 
makem: makem 
back: back 
mouth: mouth mouths 
fried: fried 
versace: versace 
violence: violence 
wanna: wanna 
kodak: kodak 
seed: seed 
getrichzay: getrichzay 
view: view 
york: york 
fox: fox 
rbaycan: rbaycan 
acrylo: acrylo 
privacy: privacy 
artist: artists 
want: want 
write: write 
calicoe: calicoe 
bout: bout 
go: go goes 
california: california 
fdm: fdm 
tarzana: tarzana 
gat: gats 
mook: mook 
memorable: memorable 
funny: funny 
rico: rico 
another: another 
cabron: cabron 
ca: ca 
movin: movin 
fonic: fonic 
equipped: equipped 
paint: paint 
ubem: ubem 
murder: murders 
run: run 
ice: ice 
small: smalls 
answer: answer 
share: share 
snatch: snatch 
recklezz: recklezz 
feat: feat 
roll: roll 
rip: rip 
cap: caps 
dropped: dropped 
gang: gang 
second: second 
never: never 
noble: noble 
quitter: quitter 
janeiro: janeiro 
onyx: onyx 
skizzy: skizzy 
k: k 
cha: cha 
think: think 
guideline: guidelines 
taker: taker 
check: check 
song: song songs 
credit: credits 
switcha: switcha 
eddie: eddie 
tucked: tucked 
november: november 
incarcerated: incarcerated 
wayne: wayne 
ruler: ruler 
mercury: mercury 
man: man 
yoshi: yoshi 
street: streets 
gonna: gonna 
puffy: puffy 
block: block 
even: even 
boppin: boppin 
extended: extended 
xay: xay 
instrumental: instrumental 
mill: mill 
kenshi: kenshi 
sour: sour 
fat: fat 
battle: battle 
capone: capone 
capital: capital 
outlawz: outlawz 
money: money 
el: el 
real: real 
warehouse: warehouse 
keef: keef 
hardcore: hardcore 
comment: comment comments 
brainstormed: brainstormed 
ay: ay 
verse: verses verse 
knee: knees 
cell: cell 
contributor: contributor contributors 
hi: hi 
eazy: eazy 
greatest: greatest 
read: read 
filmed: filmed 
biter: biter 
lil: lil 
sleep: sleep 
savage: savage 
petty: petty 
part: parts part 
tokyo: tokyo 
header: headers 
right: right rights 
anime: anime 
next: next 
nu: nu 
ren: ren 
huli: huli 
ask: ask 
written: written 
performance: performance performances 
format: format 
triple: triple 
vocalist: vocalists 
mexican: mexican 
developer: developers 
starr: starr 
fly: fly 
lobby: lobby 
rbaycanca: rbaycanca 
siedah: siedah 
mopped: mopped 
mesaj: mesaj 
bmg: bmg 
haha: haha 
phonographic: phonographic 
john: john 
salvo: salvo 
side: side 
remix: remix 
verificat: verificat 
steel: steel 
die: die 
popped: popped 
servin: servin 
pearl: pearl 
rice: rice 
slam: slam 
style: style 
chino: chino 
dead: dead 
cloud: clouds 
lootin: lootin 
visit: visit 
frisco: frisco 
jers: jers 
impersonation: impersonations 
stack: stacks 
musical: musical 
ridas: ridas 
created: created 
allegation: allegations 
game: game 
shit: shit 
crooked: crooked 
studio: studio studios 
power: power 
responded: responded 
june: june 
row: row 
flamma: flamma 
p: p 
head: head 
fair: fair 
play: play 
killed: killed 
see: see 
jerzey: jerzey 
uh: uh 
prop: props 
month: months 
nicole: nicole 
mara: mara 
dax: dax 
call: call 
somebody: somebody 
kool: kool 
smiled: smiled 
mobb: mobb 
broken: broken 
different: different 
cam: cam 
troydan: troydan 
clique: clique 
remember: remember 
knowin: knowin 
hahahaha: hahahaha 
shot: shot shots 
drama: drama 
sexual: sexual 
rus: russ 
video: videos video 
featured: featured 
cease: cease 
album: album 
tag: tags 
nothin: nothin 
ride: ride 
sampled: sampled 
xhosa: xhosa 
label: label 
grant: grants 
mothafuckas: mothafuckas 
mc: mc 
peeled: peeled 
wrath: wrath 
pat: pat 
goofy: goofy 
chingy: chingy 
ascap: ascap 
job: job jobs 
kollegah: kollegah 
got: got 
dre: dre 
planned: planned 
coast: coast 
tryna: tryna 
sickle: sickle 
edward: edwards 
type: type 
b: b 
release: release 
funkoars: funkoars 
bustin: bustin 
dennis: dennis 
rule: rules rule 
goodnight: goodnight 
controversy: controversy 
gangster: gangster 
mgk: mgk 
group: group 
rollin: rollin 
fucked: fucked 
learned: learned 
bmi: bmi 
sticky: sticky 
intro: intro 
french: french 
inc: inc 
venus: venus 
x: x 
one: one 
transcriber: transcribers 
night: night 
deceased: deceased 
track: tracks track 
pac: pac 
peace: peace 
joshua: joshua 
myke: myke 
policy: policy 
insult: insult 
publisher: publisher 
staff: staff 
bigg: bigg 
sa: sa 
cu: cu 
tamerlane: tamerlane 
kendrick: kendrick 
jasiah: jasiah 
quadruple: quadruple 
copied: copied 
friend: friends 
etc: etc 
fran: fran 
took: took 
sell: sell 
dr: dr 
soon: soon 
az: az 
biggshot: biggshot 
gunnin: gunnin 
satiric: satiric 
jayz: jayz 
lane: lane 
zay: zay 
anthem: anthem 
unconditional: unconditional 
summer: summer 
adfu: adfu 
click: click 
used: used 
annotation: annotation 
pie: pies 
grab: grab 
realest: realest 
air: air 
mob: mob 
fan: fans 
case: case 
poisonous: poisonous 
best: best 
cube: cube 
spawned: spawned 
odmgdia: odmgdia 
woah: woah 
push: push 
told: told 
genius: genius 
somethin: somethin 
nil: nil 
johnny: johnny 
lost: lost 
sample: samples sample 
featuring: featuring 
juicy: juicy 
lyte: lyte 
tupac: tupac 
press: press 
cut: cut 
five: five 
freestyle: freestyle 
incident: incident 
tot: tot 
rap: rap 
nosfe: nosfe 
heartz: heartz 
faggoty: faggoty 
worked: worked 
fatal: fatal 
pt: pt 
mike: mike 
murdered: murdered 
wide: wide 
maruego: maruego 
long: long 
yg: yg 
homie: homie 
gon: gon 
steady: steady 
u: u us 
shootin: shootin 
singin: singin 
mama: mama 
ensinando: ensinando 
verified: verified 
hit: hits hit 
n: n 
qrealwitdasteel: qrealwitdasteel 
aliz: aliz 
enlisted: enlisted 
posse: posse 
wife: wife 
g: g 
scenario: scenario 
face: face 
grandma: grandma 
skepta: skepta 
help: help 
obsessed: obsessed 
paper: paper 
mar: mars 
knowledge: knowledge 
every: every 
murda: murda 
collar: collar 
city: city 
quad: quad 
make: make 
laugh: laugh 
ar: ar 
cinema: cinema 
west: west 
dream: dream 
death: death 
bar: bars 
line: lines 
licensing: licensing 
gold: gold 
j: j 
murderer: murderer 
coked: coked 
nipsey: nipsey 
yo: yo 
life: life 
felt: felt 
th: th 
gimme: gimme 
savas: savas 
golden: golden 
mu: mu 
killin: killin 
feud: feud 
sherm: sherm 
loc: loc 
change: change changes 
doped: doped 
quick: quick 
forum: forum 
crash: crash 
interpolated: interpolated 
dima: dima 
tonight: tonight 
bamberg: bamberg 
michto: michto 
minz: minz 
said: said 
inside: inside 
mad: mad 
jun: jun 
mothafuckin: mothafuckin 
advertise: advertise 
ai: aises ais 
many: many 
add: add 
crew: crew 
smacked: smacked 
menace: menace 
shindy: shindy 
bauer: bauer 
rocky: rocky 
kelsey: kelsey 
understand: understand 
florida: florida 
jewel: jewels 
guide: guide 
trap: traps 
familia: familia 
funk: funk 
need: needs need 
shooting: shooting 
gotti: gotti 
mourn: mourn 
break: break 
sucka: sucka 
approach: approach 
ugly: ugly 
romanized: romanized 
occurs: occurs 
promote: promote 
hip: hip 
temptation: temptations 
smokin: smokin 
spank: spank 
copyright: copyright 
biggest: biggest 
dogg: dogg 
bold: bold 
began: began 
dear: dear 
herb: herbs 
f: f 
alle: alle 
shank: shank 
xl: xl 
toss: toss 
era: era 
rbe: rbe 
chappell: chappell 
contact: contact 
weaker: weaker 
em: em 
squad: squad 
riak: riak 
scene: scene 
hilltop: hilltop 
cuidando: cuidando 
ml: ml 
outlaw: outlaw 
brooklyn: brooklyn 
bomb: bomb 
posthumous: posthumous 
ayo: ayo 
also: also 
afiquacks: afiquacks 
glock: glock 
get: get 
runnin: runnin 
came: came 
mean: mean 
robbed: robbed 
bassline: bassline 
notorious: notorious 
management: management 
shooter: shooter 
kill: kill 
translation: translations translation 
approachin: approachin 
slow: slow 
amerikaz: amerikaz 
druzhba: druzhba 
vlad: vlad 
peep: peep 
caper: caper 
white: white 
puff: puff 
nation: nation 
smoked: smoked 
au: aus 
comin: comin 
fact: facts 
fake: fake 
gank: gank 
interlude: interlude 
keep: keeps keep 
lanez: lanez 
thing: things 
leonardo: leonardo 
ginex: ginex 
chris: chris 
bring: bring 
cancel: cancel 
meek: meek 
gem: gem 
z: z 
na: nas 
choke: choke 
high: high 
record: record records 
heart: hearts heart 
come: come 
solar: solar 
tory: tory 
way: way 
emi: emi 
grow: grow 
new: new 
believed: believed 
look: look 
project: project 
made: made 
self: self 
front: front 
sansar: sansar 
rea: rea 
top: top 
da: da 
ninety: nineties 
piece: pieces 
ali: ali 
level: level 
interscope: interscope 
everlast: everlast 
term: terms 
east: east 
caesar: caesar 
troublesome: troublesome 
schwarz: schwarz 
take: take 
open: open 
bringin: bringin 
reply: reply 
jetz: jetz 
black: black 
hoodie: hoodie 
original: original 
lord: lord 
whopper: whopper 
interpolate: interpolate 
franne: franne 
latinautor: latinautor 
bear: bear 
jubilee: jubilee 
walida: walida 
god: god 
blain: blain 
hop: hop 
dis: dis diss 
livin: livin 
bussin: bussin 
aise: aise 
embed: embed 
hussein: hussein 
kan: kan 
whole: whole 
men: men 
kick: kick 
first: first 
fingaz: fingaz 
poppin: poppin 
beast: beast 
sho: sho 
ninyile: ninyile 
universal: universal 
purposefully: purposefully 
opinion: opinion 
daddy: daddy 
time: time 
ft: ft 
rank: rank 
last: last 
herbovelli: herbovelli 
homies: homies 
seizure: seizure 
odds: odds 
golde: golde 
hot: hot 
radio: radio 
three: three 
settin: settin 
drugz: drugz 
drakeo: drakeo 
hussle: hussle 
well: well 
ultimate: ultimate 
attack: attack 
amill: amill 
like: like 
distinguish: distinguish 
knife: knife 
joke: joke 
varrosi: varrosi 
cover: covers 
two: two 
westside: westside 
better: better 
meine: meine 
mark: mark 
cmrra: cmrra 
theory: theory 
dmx: dmx 
fuck: fuck 
ceas: ceas 
huh: huh 
guilewa: guilewa 
snoop: snoop 
jari: jari 
frank: frank 
went: went 
accident: accident 
coppin: coppin 
angeles: angeles 
source: source 
leave: leave 
claim: claim 
trapped: trapped 
thetopseed: thetopseed 
sign: sign 
q: q 
motherfuckin: motherfuckin 
millionaire: millionaire millionaires 
pop: pop 
day: day 
hopin: hopin 
seguimos: seguimos 
r: r 
vibe: vibe 
gun: gun guns 
bummy: bummy 
cunt: cunts 
llc: llc 
direct: direct 
hour: hour 
beg: beg 
runtz: runtz 
insight: insight 
deserve: deserve 
ya: ya 
prison: prison 
e: e 
cia: cia 
million: millions 
always: always 
expand: expand 
child: child 
pistol: pistols 
garrett: garrett 
big: big 
kadafi: kadafi 
recording: recording 
feel: feel 
talkin: talkin 
plus: plus 
mac: mac 
aggravated: aggravated 
shakur: shakur 
may: may 
los: los 
repeating: repeating 
rooted: rooted 
fredro: fredro 
bhabie: bhabie 
yonezu: yonezu 
involved: involved 
til: til 
rc: rc 
herbo: herbo 
revealed: revealed 
love: love 
grady: grady 
motherfucker: motherfuckers motherfucker 
bra: bra 
ssio: ssio 
hold: hold 
sob: sob 
twork: twork 
disstrack: disstrack 
ight: ight 
andern: andern 
knot: knot 
publishing: publishing 
set: set 
azerbaijani: azerbaijani 
date: date 
wax: wax 
nane: nane 
abuse: abuse 
puya: puya 
c: c 
warned: warned 
house: house 
beef: beef 
hood: hoods 
arguably: arguably 
ak: ak 
crossed: crossed 
straight: straight 
rondonumbanine: rondonumbanine 
weak: weak 
tide: tide 
ja: ja 
interview: interview 
h: h 
stupid: stupid 
individual: individual 
cause: cause 
smoke: smoke 
belt: belts 
everybody: everybody 
method: method 
rapfilm: rapfilm 
hail: hail 
know: know 
uppercut: uppercut 
guard: guard 
personal: personal 
notch: notch 
transcription: transcription 
hahaha: hahaha 
chart: charts 
might: might 
exacerbated: exacerbated 
hard: hard 
loski: loski 
bannupprince: bannupprince 
eminem: eminem 
mothafucka: mothafucka 
yeah: yeah 
cannon: cannons 
husslaah: husslaah 
dope: dope 
jones: jones 
career: careers 
mr: mr 
spanked: spanked 
mint: mint 
full: full 
diddy: diddy 
warner: warner 
gangsta: gangsta 
kim: kim 
vicky: vicky 
carlos: carlos 
gettin: gettin 
swiss: swiss 
merc: merc 
vich: vich 
star: stars 
music: music 
l: l 
fool: fools 
comma: commas 
faker: faker 
bust: bust 
killas: killas 
rivalry: rivalry 
live: live 
cop: cops 
dressin: dressin 
keel: keel 
question: question 
mafia: mafia 
player: player 
killa: killa 
dex: dex 
drop: drop 
gotta: gotta 
seeed: seeed 
shop: shop 
produced: produced 
learn: learn 
eyez: eyez 
ahmer: ahmer 
point: points 
brutto: brutto 
wanted: wanted 
young: young 
recorded: recorded 
sheik: sheik 
royce: royce 
yaki: yaki 
ap: ap 
dj: dj 
scholar: scholars 
chaser: chaser 
directly: directly 
plea: pleas 
picture: picture 
drake: drake 
dsds: dsds 
urltv: urltv 
fell: fell 
ninho: ninho 
fuckin: fuckin 
interpolation: interpolations 
infinity: infinity 
several: several 
aresa: aresa 
mixx: mixx 
guess: guess 
glocks: glocks 
biggie: biggie 
as: ass 
version: version 
saw: saw 
otm: otm 
feed: feed 
jay: jay 
beat: beat 
umpg: umpg 
drink: drink 
finish: finish 
package: packages 
