confess: confess 
fear: fear 
trel: trel 
darkest: darkest 
talk: talk 
italic: italics 
woo: woo 
lestachette: lestachette 
chorus: chorus 
section: section 
time: times time 
nobody: nobody 
let: let 
luga: luga 
rubolino: rubolino 
deutsch: deutsch 
remixes: remixes 
ortiz: ortiz 
little: little 
andrew: andrew 
released: released 
collection: collection 
randall: randall 
tell: tell 
use: use 
grip: grip 
ended: ended 
corp: corp 
lyric: lyrics lyric 
leg: legs 
give: give 
suicide: suicide 
deep: deep 
outro: outro 
richie: richie 
dmv: dmv 
partnership: partnership 
lemar: lemar 
messam: messam 
guitar: guitar 
crip: crip 
information: information 
tear: tears 
including: including 
boy: boy 
twinkletoes: twinkletoes 
w: w 
alessia: alessia 
world: world 
holding: holdings holding 
hurting: hurting 
goin: goin 
oh: oh 
v: v 
cotto: cotto 
ballew: ballew 
perspective: perspective 
ign: ign 
banducci: banducci 
relate: relate 
back: back 
calardo: calardo 
jessica: jessica 
wanna: wanna 
armstrong: armstrong 
hotline: hotline 
york: york 
ty: ty 
alex: alex 
stylist: stylist 
ahn: ahn 
freer: freer 
thornton: thornton 
privacy: privacy 
artist: artists artist 
want: want wants 
twisted: twisted 
knowing: knowing 
care: care 
bout: bout 
loved: loved 
california: california 
alright: alright 
joyner: joyner 
another: another 
cal: cal 
jeff: jeff 
color: color 
earworm: earworm 
answer: answer 
share: share 
feat: feat 
never: never 
anyone: anyone 
k: k 
think: think 
voice: voice 
guideline: guidelines 
check: check 
song: song songs 
credit: credits 
deutsche: deutsche 
vanessa: vanessa 
wayne: wayne 
man: man 
lippi: lippi 
going: going 
even: even 
engineer: engineer 
killz: killz 
casey: casey 
fat: fat 
liar: liar 
andy: andy 
everything: everything 
underwater: underwater 
cheryl: cheryl 
comment: comment comments 
tour: tour 
mental: mental 
conductor: conductor 
commentary: commentary 
national: national 
mckeva: mckeva 
contributor: contributor contributors 
actually: actually 
kai: kai 
read: read 
lil: lil 
fleischer: fleischer 
health: health 
part: parts part 
met: met 
header: headers 
right: right rights 
background: background 
killing: killing 
ask: ask 
written: written 
performance: performance 
format: format 
taggart: taggart 
vocalist: vocalists 
south: south 
developer: developers 
road: road 
problem: problems 
robertson: robertson 
struggle: struggles 
wes: wes 
america: america 
director: director 
alive: alive 
bloo: bloo 
remix: remix 
die: die 
grown: grown 
hug: hug 
mixing: mixing 
electric: electric 
mishra: mishra 
view: view 
campbell: campbell 
musical: musical 
tyler: tyler 
visit: visit 
though: though 
created: created 
shit: shit 
beachler: beachler 
jam: jam 
studio: studio 
power: power 
persevere: persevere 
khalifa: khalifa 
chest: chest 
head: head 
p: p 
see: see 
allegro: allegro 
call: call 
somebody: somebody 
hook: hook 
schweitzer: schweitzer 
freebairn: freebairn 
seidman: seidman 
reef: reeves 
broken: broken 
different: different 
united: united 
lljs: lljs 
cara: cara 
kinz: kinz 
whose: whose 
park: park 
video: videos video 
story: stories story 
taking: taking 
featured: featured 
light: light 
album: album 
neli: neli 
tag: tags 
grant: grants 
home: home 
label: label 
parody: parody 
started: started 
today: today 
matter: matter 
ballad: ballad 
ascap: ascap 
key: key 
lusk: lusk 
got: got 
jorge: jorge 
tryna: tryna 
wiz: wiz 
melii: melii 
prevention: prevention 
type: type 
release: release 
b: b 
eun: eun 
minecraft: minecraft 
gaffer: gaffer 
anasic: anasic 
joe: joe 
group: group 
bmi: bmi 
anziety: anziety 
ettrick: ettrick 
french: french 
filming: filming 
scared: scared 
show: shows show 
nikolaeva: nikolaeva 
x: x 
one: one 
feel: feels feel 
wyreman: wyreman 
transcriber: transcribers 
night: night 
house: houses 
beyond: beyond 
darius: darius 
medaase: medaase 
fischer: fischer 
gleesh: gleesh 
precious: precious 
policy: policy 
publisher: publisher 
steve: steve 
seeing: seeing 
spree: spree 
juanes: juanes 
reason: reason 
tamerlane: tamerlane 
production: productions production 
bartone: bartone 
alternative: alternative 
shepherd: shepherd 
etc: etc 
sell: sell 
took: took 
soon: soon 
lane: lane 
writer: writer 
nspl: nspl 
blot: blot 
bobby: bobby 
annotation: annotation 
air: air 
canada: canada 
fan: fans fan 
life: lives life 
instagram: instagram 
along: along 
alec: alec 
damian: damian 
viola: viola 
david: david 
martine: martine 
podesta: podesta 
thank: thank 
genius: genius 
iv: iv 
ix: ix 
mee: mee 
nepali: nepali 
people: people 
featuring: featuring 
sample: samples sample 
anymore: anymore 
juicy: juicy 
agitated: agitated 
jumped: jumped 
press: press 
lover: lover 
bierman: bierman 
freestyle: freestyle 
mind: mind 
rap: rap 
sound: sound sounds 
kermy: kermy 
year: years 
pt: pt 
mike: mike 
title: title 
bersetzungen: bersetzungen 
long: long 
againz: againz 
commit: commit 
else: else 
u: u us 
africaryan: africaryan 
believe: believe 
messed: messed 
verified: verified 
bonfiglio: bonfiglio 
n: n 
number: number 
g: g 
jacob: jacob 
help: help 
phone: phone 
hannah: hannah 
coleman: coleman 
room: room 
knowledge: knowledge 
every: every 
available: available 
coleoiscooleo: coleoiscooleo 
representative: representative 
city: city 
shared: shared 
hedgehog: hedgehog 
finally: finally 
velasco: velasco 
death: death 
line: lines 
licensing: licensing 
j: j 
assistant: assistant 
german: german 
sony: sony 
someone: someone 
theodore: theodore 
sean: sean 
mellotron: mellotron 
cello: cello 
julie: julie 
say: say 
paula: paula 
campo: campo 
manik: manik 
praying: praying 
aw: aw 
forum: forum 
cry: cry 
said: said 
spiderman: spiderman 
advertise: advertise 
erika: erika 
conversation: conversation 
many: many 
editor: editor 
additional: additional 
add: add 
rocky: rocky 
lmsyd: lmsyd 
fact: fact facts 
understand: understand 
lifeline: lifeline 
guide: guide 
josh: josh 
sloan: sloan 
alyssa: alyssa 
calling: calling 
hines: hines 
twitter: twitter 
rose: rose 
promote: promote 
save: save 
hip: hip 
kanchi: kanchi 
job: jobs 
copyright: copyright 
antoinette: antoinette 
biggest: biggest 
forgotten: forgotten 
bold: bold 
f: f 
photography: photography 
holland: holland 
lucas: lucas 
saved: saved 
lim: lim 
contact: contact 
teased: teased 
state: state 
dragon: dragons 
yaminobahamut: yaminobahamut 
serious: serious 
ml: ml 
mine: mine 
recording: recordings recording 
alone: alone 
also: also 
get: get 
came: came 
played: played 
kill: kill 
translation: translations translation 
cartman: cartman 
goat: goats 
rysz: rysz 
contractor: contractor 
heroic: heroic 
bersetzung: bersetzung 
lucy: lucy 
end: end 
illuminati: illuminati 
arm: arms 
def: def 
norbeck: norbeck 
thing: things 
synthesizer: synthesizer 
llz: llz 
low: low 
cancel: cancel 
keanu: keanu 
race: race 
z: z 
wanting: wanting 
mission: mission 
limitless: limitless 
nice: nice 
anyway: anyway 
drowning: drowning 
new: new 
extremely: extremely 
shed: shed 
sir: sir 
brandon: brandon 
leader: leader 
made: made 
orchestra: orchestra 
montana: montana 
callin: callin 
mix: mix 
noah: noah 
term: terms 
without: without 
popularity: popularity 
well: wells well 
aka: aka 
hung: hung 
take: take 
randomly: randomly 
black: black 
tune: tunes 
lord: lord 
funes: funes 
interpolate: interpolate 
kythre: kythre 
god: god 
hop: hop 
lightness: lightness 
statement: statement 
trying: trying 
happen: happen 
embed: embed 
whole: whole 
first: first 
durk: durk 
universal: universal 
ft: ft 
travel: travel 
last: last 
hotties: hotties 
galaxy: galaxy 
visionary: visionary 
radio: radio 
three: three 
hot: hot 
lerios: lerios 
kinzagainz: kinzagainz 
cuayo: cuayo 
ultimate: ultimate 
comfort: comfort 
string: string 
ink: ink 
like: like 
distinguish: distinguish 
hudson: hudson 
cover: covers 
various: various 
mark: mark 
piano: piano 
hurt: hurt 
jung: jung 
fuck: fuck 
everythang: everythang 
went: went 
angeles: angeles 
source: source 
sign: sign 
justin: justin 
q: q 
reflection: reflection 
matt: matt 
day: day 
nami: nami 
pop: pop 
r: r 
place: place 
melumad: melumad 
done: done 
country: country 
smith: smith 
supervisor: supervisor 
bass: bass 
llc: llc 
brett: brett 
official: official 
insight: insight 
giovanni: giovanni 
e: e 
always: always 
expand: expand 
definitely: definitely 
april: april 
talkin: talkin 
pain: pain 
khalid: khalid 
christopher: christopher 
designer: designer 
melt: melt 
mac: mac 
los: los 
repeating: repeating 
imagine: imagine 
luke: luke 
dark: dark 
track: track 
til: til 
silenced: silenced 
love: love 
hit: hit 
katie: katie 
detail: details 
optimist: optimist 
publishing: publishing 
sam: sam 
soul: soul 
date: date 
girl: girls 
c: c 
meal: meals 
thanks: thanks 
jeremy: jeremy 
maurer: maurer 
conscious: conscious 
logic: logic 
sorry: sorry 
mashup: mashup 
interview: interview 
h: h 
zone: zone 
individual: individual 
mo: mos 
everybody: everybody 
eric: eric 
apart: apart 
know: know 
stare: stare 
personal: personal 
hallelujah: hallelujah 
transcription: transcription 
chart: charts 
might: might 
hard: hard 
pre: pre 
dylan: dylan 
convince: convince 
gone: gone 
bus: bus 
decides: decides 
caller: caller 
matthew: matthew 
snow: snow 
canadiana: canadiana 
socan: socan 
breath: breath 
waiting: waiting 
warner: warner 
vocal: vocals 
arranger: arranger 
kim: kim 
record: records 
cimorelli: cimorelli 
music: music 
l: l 
really: really 
lee: lee 
live: live 
question: question 
producer: producer 
speak: speak 
gotta: gotta 
drop: drop 
dria: dria 
shop: shop 
produced: produced 
learn: learn 
violin: violin 
vulture: vulture 
car: car 
gordon: gordon 
dxwnfvng: dxwnfvng 
verse: verse 
happened: happened 
recorded: recorded 
executive: executive 
moving: moving 
nahi: nahi 
ap: ap 
andr: andr 
dj: dj 
scholar: scholars 
interpolation: interpolations 
entertainment: entertainment 
tat: tat 
atv: atv 
dolla: dolla 
