moccasin: moccasins 
graven: graven 
damn: damn 
sheet: sheets 
frosty: frosty 
jacket: jacket 
italic: italics 
bargain: bargain 
bitch: bitch 
pamkutya: pamkutya 
chorus: chorus 
saving: saving 
section: section 
incredible: incredible 
girl: girl girls 
found: found 
let: let 
mista: mista 
team: team 
country: countries 
baker: baker 
undertale: undertale 
remixes: remixes 
chela: chela 
released: released 
hipster: hipster 
traductions: traductions 
telescope: telescope 
collection: collection 
use: use 
fallon: fallon 
lyric: lyrics lyric 
deep: deep 
outro: outro 
stop: stop 
trash: trash 
grammy: grammy 
starting: starting 
information: information 
outlet: outlet 
rapper: rapper 
including: including 
museum: museum 
boy: boy 
certified: certified 
kid: kids 
dnk: dnk 
w: w 
six: six 
walk: walk 
world: world 
holding: holdings 
ed: ed 
line: line lines 
diamond: diamond 
grandpa: grandpa 
wearin: wearin 
oh: oh 
traduction: traduction 
v: v 
massage: massage 
cowboy: cowboy 
cold: cold 
wa: wa 
swagged: swagged 
addition: addition 
much: much 
wake: wake 
alex: alex 
fox: fox 
dambo: dambo 
jumpsuit: jumpsuit 
bradlee: bradlee 
dookie: dookie 
narwhal: narwhal 
privacy: privacy 
artist: artists 
kelly: kelly 
boogie: boogie 
stirling: stirling 
bout: bout 
loved: loved 
go: go 
another: another 
lt: lt 
bombom: bombom 
ninety: ninety 
robyn: robyn 
ice: ice 
kidz: kidz 
earworm: earworm 
answer: answer 
share: share 
classiques: classiques 
message: message 
second: second 
sherry: sherry 
auction: auction 
skeet: skeet 
k: k 
guideline: guidelines 
check: check 
song: song songs 
garvey: garvey 
credit: credits 
cheese: cheese 
megamashup: megamashup 
flossin: flossin 
wayne: wayne 
simple: simple 
asian: asian 
man: man 
gonna: gonna 
called: called 
portrayed: portrayed 
even: even 
lap: lap 
honkey: honkey 
engineer: engineer 
happy: happy 
battle: battle 
liar: liar 
shop: shops shop 
thousand: thousand 
huge: huge 
money: money 
cathedral: cathedral 
slipper: slippers 
real: real 
ii: ii 
ee: ee 
comment: comment comments 
coat: coat 
martinez: martinez 
huntington: huntington 
contributor: contributor contributors 
actually: actually 
read: read 
standin: standin 
meme: memes meme 
part: parts part 
next: next 
right: right rights 
header: headers 
street: street 
ask: ask 
written: written 
performance: performance 
huntin: huntin 
format: format 
vocalist: vocalists 
passin: passin 
ah: ah 
american: american 
developer: developers 
road: road 
probably: probably 
expensive: expensive 
bridge: bridge 
hopkinson: hopkinson 
cept: cept 
fremont: fremont 
stuck: stuck 
vine: vine 
plaid: plaid 
john: john 
ccckr: ccckr 
tricked: tricked 
mixing: mixing 
view: view 
style: style 
blanket: blanket 
become: become 
musical: musical 
visit: visit 
created: created 
shit: shit 
game: game 
flannel: flannel 
studio: studio studios 
ryanlewis: ryanlewis 
p: p 
down: downs 
wolf: wolf 
call: call 
broken: broken 
different: different 
united: united 
pro: pro 
ignorant: ignorant 
jukebox: jukebox 
knowin: knowin 
bought: bought 
luggage: luggage 
mucklemore: mucklemore 
rock: rock 
hour: hours 
red: red 
charlie: charlie 
sheeran: sheeran 
video: videos 
backed: backed 
brand: brand 
featured: featured 
cool: cool 
tag: tags 
light: light 
bart: bart 
grant: grants 
parody: parody 
character: character 
simplly: simplly 
today: today 
victory: victory 
mezzanine: mezzanine 
appeared: appeared 
al: al 
delight: delight 
key: key 
leopard: leopard 
ba: ba 
got: got 
pentatonix: pentatonix 
ace: ace 
tryna: tryna 
location: locations 
fringe: fringe 
eeoneguy: eeoneguy 
type: type 
searchin: searchin 
gear: gear 
release: release 
b: b 
seemed: seemed 
knight: knight 
pluffaduff: pluffaduff 
boot: boots 
getting: getting 
rollin: rollin 
would: would 
quavo: quavo 
bmi: bmi 
intro: intro 
french: french 
polka: polka 
filming: filming 
show: shows show 
wilson: wilson 
liang: liang 
green: green 
brown: brown 
one: one 
wild: wild 
transcriber: transcribers 
osama: osama 
x: x 
conan: conan 
lhugueny: lhugueny 
discount: discount 
macklemore: macklemore 
yankovic: yankovic 
gipp: gipp 
policy: policy 
knee: knee 
washed: washed 
publisher: publisher 
head: heads 
edward: edward 
ten: ten 
jasiah: jasiah 
living: living 
sell: sell 
etc: etc 
could: could 
beside: beside 
fran: fran 
took: took 
arcade: arcade 
wall: walls wall 
stuntin: stuntin 
paul: paul 
cock: cock 
dressed: dressed 
annotation: annotation 
swindled: swindled 
canada: canada 
daymanoursavior: daymanoursavior 
richard: richard 
mall: mall 
thank: thank 
genius: genius 
smell: smells 
leather: leather 
scott: scott 
people: people 
featuring: featuring 
wanz: wanz 
sample: samples sample 
bin: bins 
blue: blue 
alban: alban 
press: press 
club: club 
rap: rap 
sound: sound 
year: years 
pt: pt 
priscilla: priscilla 
onesie: onesie 
sherlock: sherlock 
clothing: clothing 
else: else 
u: u us 
noggin: noggin 
edition: edition 
mama: mama 
verified: verified 
n: n 
northwest: northwest 
number: number 
clay: clay 
g: g 
grandma: grandma 
chad: chad 
primary: primary 
twenty: twenty 
dum: dum 
grungy: grungy 
knowledge: knowledge 
bop: bop 
pocket: pocket 
make: make 
dv: dv 
wing: wings wing 
death: death 
weird: weird 
gold: gold 
ave: ave 
shoe: shoes 
licensing: licensing 
j: j 
yo: yo 
th: th 
someone: someone 
predict: predict 
velour: velour 
goodwill: goodwill 
cent: cents 
awesome: awesome 
seda: seda 
change: change 
village: village 
forum: forum 
lookin: lookin 
ryan: ryan 
inside: inside 
mellow: mellow 
advertise: advertise 
ceo: ceo 
ai: aises ais 
many: many 
baykara: baykara 
additional: additional 
built: built 
add: add 
nothing: nothing 
hey: hey 
limited: limited 
august: august 
piss: piss 
understand: understand 
hella: hella 
guide: guide 
donatin: donatin 
extreme: extreme 
history: history 
brun: brun 
postmodern: postmodern 
rockin: rockin 
tight: tight 
velcro: velcros 
promote: promote 
hip: hip 
fucking: fucking 
kobalt: kobalt 
job: jobs 
copyright: copyright 
biggest: biggest 
bold: bold 
hill: hill 
rider: rider 
valley: valley 
f: f 
dollar: dollars 
cover: cover covers 
board: board 
shirt: shirt 
diggity: diggity 
contact: contact 
melanie: melanie 
em: em 
draped: draped 
state: state 
scene: scene 
yaminobahamut: yaminobahamut 
rise: rises 
ml: ml 
brooklyn: brooklyn 
also: also 
anderson: anderson 
get: get 
decade: decade 
passenger: passenger 
translation: translations translation 
vintage: vintage 
label: labels 
peep: peep 
hello: hello 
white: white 
spoon: spoons 
vulture: vultures 
fact: facts 
passage: passage 
ter: ter 
gucci: gucci 
ho: ho 
low: low 
cancel: cancel 
z: z 
elliott: elliott 
come: come 
crossley: crossley 
wear: wear 
mastering: mastering 
headed: headed 
look: look 
capitol: capitol 
vincent: vincent 
party: party 
nah: nah 
january: january 
da: da 
button: button 
ali: ali 
term: terms 
take: take 
empire: empire 
chance: chance 
bar: bar 
interpolate: interpolate 
whopper: whopper 
scratch: scratches 
pumped: pumped 
hop: hop 
mink: mink 
aise: aise 
embed: embed 
fung: fung 
men: men 
poppin: poppin 
stunting: stunting 
fifty: fifty 
ft: ft 
last: last 
main: main 
african: african 
hot: hot 
castle: castle 
heist: heist 
well: well 
ultimate: ultimate 
thin: thin 
nine: nine 
super: super 
like: like 
distinguish: distinguish 
sneaker: sneaker 
vient: vient 
various: various 
mark: mark 
seattle: seattle 
fuck: fuck 
granddad: granddad 
coppin: coppin 
source: source 
australia: australia 
hand: hand 
sign: sign 
brien: brien 
justin: justin 
regicidal: regicidal 
q: q 
dat: dat 
davis: davis 
pop: pop 
r: r 
place: place 
bag: bag 
grouch: grouch 
fur: fur 
bummy: bummy 
rucka: rucka 
lindsey: lindsey 
llc: llc 
walkin: walkin 
jimmy: jimmy 
pisscord: pisscord 
insight: insight 
obama: obama 
e: e 
expand: expand 
big: big 
hell: hell 
recording: recording 
compliment: compliments 
episode: episode 
ditching: ditching 
repeating: repeating 
iovine: iovine 
dark: dark 
track: track 
unicorn: unicorn 
bieber: bieber 
love: love 
hit: hit 
find: find 
hold: hold 
publishing: publishing 
thrift: thrift 
sterling: sterling 
adele: adele 
tinyd: tinyd 
date: date 
platinum: platinum 
c: c 
finny: finny 
house: house 
megamix: megamix 
skin: skin 
te: tes 
jammies: jammies 
mashup: mashup 
sock: socks 
interview: interview 
h: h 
individual: individual 
auntie: auntie 
diggin: diggin 
cause: cause 
single: single 
lp: lp 
sesame: sesame 
know: know 
henry: henry 
personal: personal 
gator: gator 
pink: pink 
illusionisten: illusionisten 
transcription: transcription 
hahaha: hahaha 
chart: charts 
might: might 
cher: cher 
yeah: yeah 
brother: brothers 
dope: dope 
jones: jones 
brian: brian 
washin: washin 
vocal: vocals 
keyboard: keyboard 
record: records 
store: store 
hillywood: hillywood 
madilyn: madilyn 
lewis: lewis 
zebra: zebra 
value: value 
music: music 
l: l 
comedy: comedy 
business: business 
question: question 
clothes: clothes 
war: war 
outsider: outsider 
neon: neon 
drop: drop 
produced: produced 
learn: learn 
zaehd: zaehd 
verse: verse 
anthony: anthony 
recorded: recorded 
fantasy: fantasy 
grinnell: grinnell 
funky: funky 
dj: dj 
scholar: scholars 
motherfucker: motherfucker 
pimped: pimped 
shopping: shopping 
several: several 
mammy: mammy 
gregory: gregory 
quadeca: quadeca 
as: ass 
jay: jay 
beat: beat 
timberlake: timberlake 
