nico: nico 
sia: sia 
damn: damn 
recurring: recurring 
shapiro: shapiro 
tradu: tradu 
famous: famous 
italic: italics 
woo: woo 
serving: serving 
naaz: naaz 
chorus: chorus 
tj: tj 
still: still 
section: section 
time: times time 
sport: sport 
act: act 
nobody: nobody 
found: found 
ye: ye 
let: let 
throughout: throughout 
february: february 
nigga: nigga 
blessing: blessings 
feedback: feedback 
vers: vers 
credited: credited 
good: good 
prayer: prayer prayers 
cyhi: cyhi 
pour: pour 
little: little 
andrew: andrew 
released: released 
traductions: traductions 
collection: collection 
neck: neck 
focus: focus 
painted: painted 
spirit: spirit 
tell: tell 
use: use 
monza: monza 
svenska: svenska 
detract: detract 
month: month 
corp: corp 
lyric: lyrics lyric 
touch: touch 
debt: debt 
ttning: ttning 
give: give 
outro: outro 
heavy: heavy 
proclaimed: proclaimed 
grammy: grammy 
guitar: guitar 
information: information 
rapper: rapper 
including: including 
swizz: swizz 
demo: demo 
overture: overture 
boy: boy 
redan: redan 
franklin: franklin 
minimal: minimal 
w: w 
college: college 
wave: waves wave 
world: world 
holding: holdings 
rick: rick 
karina: karina 
traduction: traduction 
oh: oh 
v: v 
fml: fml 
back: back 
sky: sky 
wanna: wanna 
hand: hands hand 
hallej: hallej 
much: much 
myne: myne 
whitlow: whitlow 
pastor: pastor 
concord: concord 
privacy: privacy 
artist: artists artist 
want: want 
yes: yes 
parent: parents 
zambia: zambia 
commented: commented 
write: write 
kelly: kelly 
twisted: twisted 
writing: writing writings 
care: care 
loved: loved 
go: go 
alright: alright 
rainbow: rainbow 
ubem: ubem 
eviri: eviri 
answer: answer 
ronza: ronza 
share: share 
snatch: snatch 
never: never 
far: far 
k: k 
stormzy: stormzy 
co: co 
malik: malik 
guideline: guidelines 
name: name 
check: check 
stretch: stretch 
song: song songs 
credit: credits 
impel: impel 
gonna: gonna 
going: going 
feature: features feature 
blackwood: blackwood 
desert: desert 
even: even 
engineer: engineer 
extended: extended 
described: described 
thing: thing 
post: post 
liar: liar 
santiago: santiago 
arthur: arthur 
titled: titled 
chavonne: chavonne 
leite: leite 
everything: everything 
damascus: damascus 
shanika: shanika 
rubin: rubin 
bernstein: bernstein 
real: real 
ii: ii 
jabriel: jabriel 
comment: comment comments 
scheme: scheme 
commentary: commentary 
looking: looking 
contributor: contributor contributors 
chano: chano 
bbc: bbc 
donda: donda 
baptist: baptist 
greatest: greatest 
read: read 
jerome: jerome 
mess: mess 
lil: lil 
oppression: oppression 
underground: underground 
requiem: requiem 
english: english 
free: free 
part: parts part 
met: met 
header: headers 
right: right rights 
background: background 
janet: janet 
performance: performance 
ask: ask 
written: written 
format: format 
triple: triple 
vocalist: vocalists 
service: service 
larissa: larissa 
developer: developers 
style: styles 
samo: samo 
bridge: bridge 
party: parties 
heat: heat 
droogie: droogie 
prominent: prominent 
bmg: bmg 
flip: flip 
remix: remix 
salt: salt 
wesley: wesley 
rk: rk 
sunday: sunday 
mixing: mixing 
view: view 
fade: fade 
musical: musical 
visit: visit 
harry: harry 
created: created 
studio: studio 
jam: jam 
runaway: runaway 
head: head 
p: p 
marroquin: marroquin 
see: see 
disorient: disorient 
brentwood: brentwood 
rival: rival 
fun: fun 
broken: broken 
different: different 
fight: fight 
gosh: gosh 
vida: vida 
deliver: deliver 
hour: hours 
rock: rock 
red: red 
enough: enough 
charlie: charlie 
e: es e 
video: videos 
chant: chants 
featured: featured 
light: light lights 
album: album 
tag: tags 
ride: ride 
home: home 
word: words 
label: label 
remained: remained 
pat: pat 
benson: benson 
keyboard: keyboards 
island: island 
trumpet: trumpet 
michael: michael 
ascap: ascap 
al: al 
job: job jobs 
wap: wap 
blinded: blinded 
tryna: tryna 
rhyme: rhyme 
george: george 
type: type 
release: release 
b: b 
teaching: teachings 
expose: expose 
mp: mp 
robson: robson 
evans: evans 
pray: pray 
equal: equal 
group: group 
greene: greene 
hear: hear 
bmi: bmi 
papa: papa 
together: together 
intro: intro 
svensk: svensk 
joint: joint 
green: green 
one: one 
feel: feels feel 
stewart: stewart 
transcriber: transcribers 
djds: djds 
night: night 
x: x 
besides: besides 
lot: lot 
peace: peace 
trail: trail 
doctrine: doctrine 
via: via 
policy: policy 
publisher: publisher 
steve: steve 
anteater: anteater 
tamerlane: tamerlane 
kendrick: kendrick 
choir: choir 
sell: sell 
etc: etc 
friend: friends friend 
fran: fran 
portugu: portugu 
bereal: bereal 
paris: paris 
paul: paul 
lovely: lovely 
loving: loving 
snap: snap 
wolf: wolves 
reminiscent: reminiscent 
gospel: gospel 
annotation: annotation 
cub: cub 
bet: bet 
instagram: instagram 
father: father 
best: best 
polish: polish 
duration: duration 
somewhere: somewhere 
coming: coming 
genius: genius 
millz: millz 
amra: amra 
lost: lost 
people: people 
featuring: featuring 
sample: samples sample 
day: days day 
influential: influential 
press: press 
freestyle: freestyle 
gummy: gummy 
rap: rap 
otis: otis 
sound: sound 
year: years 
worked: worked 
ultralight: ultralight 
pt: pt 
mike: mike 
nominated: nominated 
photo: photos 
tiffany: tiffany 
dixon: dixon 
grammys: grammys 
else: else 
chatham: chatham 
u: u us 
matic: matic 
notepad: notepad 
messed: messed 
verified: verified 
n: n 
safe: safe 
g: g 
figure: figures 
candy: candy 
kirk: kirk 
afraid: afraid 
dawson: dawson 
knowledge: knowledge 
every: every 
sightless: sightless 
blind: blind 
artwork: artwork 
sesac: sesac 
city: city 
make: make makes 
laugh: laugh 
west: west 
dream: dream 
death: death 
bar: bars 
coachella: coachella 
line: lines 
tea: tea 
licensing: licensing 
brasil: brasil 
j: j 
motif: motif 
sony: sony 
throw: throw 
life: life 
th: th 
gimme: gimme 
milligan: milligan 
sean: sean 
italiane: italiane 
ultralit: ultralit 
pablo: pablo 
ol: ol 
field: field 
devil: devil devils 
preacher: preacher 
praying: praying 
sure: sure 
forum: forum 
braille: braille 
late: late 
manny: manny 
ryan: ryan 
traducciones: traducciones 
bentley: bentley 
said: said 
paradox: paradox 
advertise: advertise 
santi: santi 
ai: aises ais 
many: many 
dernier: dernier 
additional: additional 
add: add 
stevenson: stevenson 
hey: hey 
spike: spike 
swedish: swedish 
strong: strong 
dean: dean 
local: local 
understand: understand 
guide: guide 
praise: praise 
traduzione: traduzione 
familia: familia 
theology: theology 
darn: darn 
sight: sight 
walker: walker 
segal: segal 
journeying: journeying 
ab: ab 
twitter: twitter 
please: please 
georgio: georgio 
promote: promote 
hip: hip 
kobalt: kobalt 
pam: pam 
price: price 
tubman: tubman 
foot: foot 
melody: melody 
biggest: biggest 
copyright: copyright 
bold: bold 
hood: hood 
dorian: dorian 
f: f 
everyone: everyone 
umaczenie: umaczenie 
old: old 
cover: cover covers 
plain: plain 
pentecostal: pentecostal 
chappell: chappell 
en: en 
contact: contact 
em: em 
turkish: turkish 
similar: similar 
azure: azure 
ml: ml 
art: art 
mine: mine 
drifted: drifted 
production: production 
recording: recordings recording 
also: also 
parallel: parallels 
considered: considered 
eye: eyes 
umaczenia: umaczenia 
mean: mean 
management: management 
translation: translations translation 
dropout: dropout 
jesus: jesus 
traducci: traducci 
sinister: sinister 
contractor: contractor 
church: church 
stan: stan 
fact: facts 
end: end 
tweet: tweet 
def: def 
low: low 
cancel: cancel 
kenyon: kenyon 
lido: lido 
echo: echoes 
z: z 
high: high 
holy: holy 
come: come 
solar: solar 
turn: turn 
way: way ways 
emi: emi 
new: new 
look: look 
made: made 
encina: encina 
ugh: ugh 
polaris: polaris 
raincoat: raincoats 
noah: noah 
term: terms 
polskie: polskie 
surffffeeeeer: surffffeeeeer 
take: take 
preached: preached 
jlol: jlol 
lamar: lamar 
chance: chance 
lord: lord 
tune: tunes 
interpolate: interpolate 
whopper: whopper 
latinautor: latinautor 
god: god 
hop: hop 
keep: keep 
la: la 
lakesha: lakesha 
aise: aise 
embed: embed 
gina: gina 
first: first 
universal: universal 
ft: ft 
daddy: daddy 
intermission: intermission 
saul: saul 
digital: digital 
hot: hot 
radio: radio 
three: three 
title: titles 
establishes: establishes 
influence: influences 
since: since 
kilhoffer: kilhoffer 
well: well 
ultimate: ultimate 
judge: judge 
wrong: wrong wrongs 
like: like 
distinguish: distinguish 
crystal: crystal 
two: two 
highlight: highlights 
fonzworth: fonzworth 
acodem: acodem 
demon: demons 
cmrra: cmrra 
question: questions question 
treat: treat 
follow: follow 
kanye: kanye 
fuck: fuck 
book: books 
reveal: reveal 
beatz: beatz 
frank: frank 
source: source 
need: need 
emmitt: emmitt 
sign: sign 
obvious: obvious 
q: q 
regaining: regaining 
beam: beam 
davis: davis 
pop: pop 
r: r 
noise: noise 
attention: attention 
count: count 
espoir: espoir 
spanish: spanish 
bass: bass 
llc: llc 
mumbo: mumbo 
faith: faith 
lounge: lounge 
insight: insight 
kak: kak 
daughter: daughter 
expand: expand 
child: child 
samoria: samoria 
big: big 
hell: hell 
satan: satan 
luxury: luxury 
script: script 
pain: pain 
april: april 
great: great 
portuguese: portuguese 
peder: peder 
repeating: repeating 
strength: strength 
christian: christian christians 
dark: dark 
iz: iz 
track: track 
sung: sung 
although: although 
til: til 
resurrection: resurrection 
love: love 
hit: hit 
peermusic: peermusic 
family: family 
fail: fail 
publishing: publishing 
natalie: natalie 
shantell: shantell 
glory: glory 
soul: soul 
persecute: persecute 
date: date 
ex: ex 
platinum: platinum 
girl: girls 
dedicating: dedicating 
send: send 
finny: finny 
c: c 
house: house 
meurt: meurt 
conscious: conscious 
march: march 
sorry: sorry 
weak: weak 
h: h 
individual: individual 
mistake: mistakes 
cause: cause 
internet: internet 
testament: testament 
everybody: everybody 
early: early 
aaron: aaron 
billy: billy 
know: know 
kota: kota 
personal: personal 
hallelujah: hallelujah 
transcription: transcription 
native: natives 
chart: charts 
might: might 
rachel: rachel 
hard: hard 
pedl: pedl 
heaven: heaven 
yeah: yeah 
toasty: toasty 
redding: redding 
mr: mr 
canadiana: canadiana 
warner: warner 
running: running 
vocal: vocals 
brother: brother 
sing: sing 
lewis: lewis 
walk: walks 
italian: italian 
music: music 
earlier: earlier 
l: l 
longer: longer 
serenity: serenity 
live: live 
producer: producer 
war: war 
bam: bam 
something: something 
speak: speak 
gotta: gotta 
drop: drop 
yellow: yellow 
espa: espa 
shop: shop 
produced: produced 
shield: shield 
learn: learn 
saint: saint 
verse: verse 
anthony: anthony 
young: young 
moving: moving 
st: st 
pangaea: pangaea 
italiana: italiana 
dj: dj 
administration: administration 
scholar: scholars 
apostle: apostle 
malchicoff: malchicoff 
fire: fire 
siiiiiiiiilver: siiiiiiiiilver 
goldstein: goldstein 
lol: lol 
hub: hub 
viva: viva 
interpolation: interpolations 
neo: neo 
pillar: pillar 
cannot: cannot 
aresa: aresa 
as: ass 
version: version 
traduzioni: traduzioni 
yusef: yusef 
entertainment: entertainment 
jay: jay 
italiano: italiano 
atv: atv 
abramus: abramus 
dictated: dictated 
