eg: eg 
chubby: chubby 
recurring: recurring 
tradu: tradu 
italic: italics 
woe: woes 
belonged: belonged 
chorus: chorus 
tj: tj 
section: section 
girl: girl 
finer: finer 
gi: gi 
international: international 
throughout: throughout 
february: february 
nigga: nigga niggas 
vinylz: vinylz 
drum: drum 
remixes: remixes 
mash: mash 
toronto: toronto 
released: released 
collection: collection 
exposed: exposed 
insane: insane 
sellin: sellin 
stoeckart: stoeckart 
use: use 
wednesday: wednesday 
fallon: fallon 
latinautorperf: latinautorperf 
lyric: lyrics lyric 
riddim: riddim 
outro: outro 
put: put 
information: information 
including: including 
sleepin: sleepin 
boy: boy 
po: po 
certified: certified 
w: w 
world: world 
holding: holdings 
de: de 
line: line lines 
ancient: ancient 
v: v vs 
pepper: pepper 
back: back 
wanna: wanna 
nariman: nariman 
york: york 
jewelry: jewelry 
reign: reign 
privacy: privacy 
artist: artists 
want: want 
care: care 
bout: bout 
go: go goes 
dane: dane 
suck: suck 
hashtags: hashtags 
tracy: tracy 
juice: juice 
ubem: ubem 
eviri: eviri 
ice: ice 
answer: answer 
share: share 
uncle: uncle 
dropped: dropped 
declare: declare 
sonyatv: sonyatv 
heraclitus: heraclitus 
k: k 
evaboy: evaboy 
co: co 
guideline: guidelines 
check: check 
song: song songs 
credit: credits 
ferrari: ferrari 
countin: countin 
socrates: socrates 
dun: dun 
republic: republic 
man: man 
street: streets 
hat: hat 
even: even 
engineer: engineer 
tellin: tellin 
thing: thing things 
un: un 
money: money 
real: real 
ii: ii 
comment: comment comments 
truth: truth 
commentary: commentary 
book: book 
contributor: contributor contributors 
greatest: greatest 
read: read 
lil: lil 
english: english 
riaa: riaa 
part: parts part 
bomboclat: bomboclat 
header: headers 
unruly: unruly 
chromatic: chromatic 
ask: ask 
written: written 
performance: performance 
format: format 
phrase: phrase 
vocalist: vocalists 
cupid: cupid 
developer: developers 
preach: preach 
road: road 
jus: jus 
yuhself: yuhself 
ballin: ballin 
youth: youth 
phonographic: phonographic 
pittsburgh: pittsburgh 
side: side 
wrld: wrld 
rk: rk 
view: view 
musical: musical 
visit: visit 
technomarine: technomarine 
created: created 
boomin: boomin 
shit: shit 
khalifa: khalifa 
embraced: embraced 
june: june 
theme: theme 
p: p 
head: head 
neither: neither 
execute: execute 
checklist: checklist 
broken: broken 
different: different 
vida: vida 
star: star 
e: es e 
video: videos 
featured: featured 
flow: flow 
album: album 
tag: tags 
grant: grants 
ride: ride 
songwriter: songwriter 
label: label 
evan: evan 
parody: parody 
hol: hol 
stumbled: stumbled 
patch: patch 
ascap: ascap 
al: al 
job: job jobs 
fader: fader 
got: got 
wiz: wiz 
metro: metro 
type: type 
whip: whip 
referenced: referenced 
release: release 
b: b 
right: rights 
pray: pray 
group: group 
would: would 
intro: intro 
x: x 
stewart: stewart 
transcriber: transcribers 
elevate: elevate 
night: night 
received: received 
sage: sages 
via: via 
policy: policy 
publisher: publisher 
etc: etc 
sell: sell 
took: took 
portugu: portugu 
soon: soon 
shot: shots 
used: used 
annotation: annotation 
aphorism: aphorism 
nuh: nuh 
hardy: hardy 
canada: canada 
company: company 
bank: bank 
pm: pm 
polish: polish 
woah: woah 
duration: duration 
told: told 
genius: genius 
ethan: ethan 
scott: scott 
johnny: johnny 
sample: samples sample 
purpose: purpose 
press: press 
freestyle: freestyle 
cute: cute 
rap: rap 
swerve: swerve 
hatchback: hatchback 
programmer: programmer 
rep: reps 
tracey: tracey 
forever: forever 
lead: lead 
nasty: nasty 
u: u us 
verified: verified 
n: n 
network: network 
number: number 
madonna: madonna 
ritter: ritter 
g: g 
phone: phone 
shakiness: shakiness 
strictly: strictly 
bucket: bucket 
singing: singing 
knowledge: knowledge 
envious: envious 
jean: jeans 
city: city 
jibba: jibba 
dizaster: dizaster 
perfection: perfection 
death: death 
brasil: brasil 
licensing: licensing 
j: j 
assistant: assistant 
sony: sony 
life: life 
turned: turned 
doughnut: doughnuts 
oliver: oliver 
say: say 
ol: ol 
forum: forum 
late: late 
quentin: quentin 
traducciones: traducciones 
woman: women 
said: said 
advertise: advertise 
twin: twin 
additional: additional 
monologue: monologue 
add: add 
nothing: nothing 
polo: polos 
pushin: pushin 
understand: understand 
guide: guide 
history: history 
dropping: dropping 
trawick: trawick 
rockin: rockin 
popcaan: popcaan 
promote: promote 
copyright: copyright 
biggest: biggest 
bold: bold 
yuh: yuh 
isaac: isaac 
f: f 
witch: witch 
umaczenie: umaczenie 
contact: contact 
energy: energy 
em: em 
turkish: turkish 
serious: serious 
ml: ml 
jan: jan 
recording: recordings recording 
also: also 
distributor: distributor 
get: get 
runnin: runnin 
umaczenia: umaczenia 
management: management 
passenger: passenger 
translation: translations translation 
traducci: traducci 
eye: eye 
bugatti: bugatti 
boi: boi 
upon: upon 
fact: facts 
interlude: interlude 
athens: athens 
kno: kno 
reading: reading 
chris: chris 
cancel: cancel 
trap: trap 
z: z 
high: high 
record: record records 
solar: solar 
noel: noel 
mastering: mastering 
way: way 
cream: cream 
new: new 
look: look 
dumbfoundead: dumbfoundead 
made: made 
capo: capo 
top: top 
da: da 
ovo: ovo 
career: career 
sola: sola 
without: without 
gbe: gbe 
term: terms 
polskie: polskie 
holiday: holiday 
yungen: yungen 
fort: fort 
take: take 
black: black 
jodeci: jodeci 
original: original 
interpolate: interpolate 
latinautor: latinautor 
legend: legend 
warrior: warrior 
god: god 
yute: yute 
otha: otha 
dis: dis diss 
la: la 
dfill: dfill 
embed: embed 
allen: allen 
first: first 
poppin: poppin 
universal: universal 
named: named 
elated: elated 
ft: ft 
time: time 
fine: fine 
hot: hot 
three: three 
shortly: shortly 
bos: boss 
irrational: irrational 
ultimate: ultimate 
jungle: jungle 
like: like 
distinguish: distinguish 
cover: covers 
two: two 
syk: syk 
apology: apology 
mark: mark 
cmrra: cmrra 
shaky: shaky 
hurt: hurt 
kanye: kanye 
fuck: fuck 
uk: uk 
source: source 
fiz: fiz 
sign: sign 
justin: justin 
q: q 
stay: stay 
faneto: faneto 
r: r 
girbaud: girbaud 
gun: gun 
spanish: spanish 
machine: machine 
llc: llc 
gemitaiz: gemitaiz 
jimmy: jimmy 
jswizz: jswizz 
insight: insight 
deserve: deserve 
baka: baka 
always: always 
expand: expand 
definitely: definitely 
big: big 
must: must 
winnie: winnie 
talkin: talkin 
hazelton: hazelton 
designer: designer 
portuguese: portuguese 
repeating: repeating 
track: track 
glass: glass 
love: love 
hit: hit 
find: find 
subaru: subaru 
aj: aj 
backpack: backpacks 
soul: soul 
miller: miller 
greek: greek 
date: date 
cadastre: cadastre 
platinum: platinum 
rudder: rudder 
pythagoras: pythagoras 
c: c 
cash: cash 
urself: urself 
h: h 
individual: individual 
can: cans 
certification: certifications 
single: single 
thyself: thyself 
know: know 
personal: personal 
transcription: transcription 
chart: charts 
might: might 
iyrtitl: iyrtitl 
shell: shell 
yeah: yeah 
turnin: turnin 
haffi: haffi 
pasosh: pasosh 
think: thinks 
running: running 
vocal: vocals 
band: bands 
proud: proud 
bling: bling 
music: music 
coran: coran 
short: short 
l: l 
fake: fakes 
attributed: attributed 
global: global 
live: live 
travis: travis 
question: question 
baffled: baffled 
producer: producer 
drop: drop 
mada: mada 
yellow: yellow 
espa: espa 
shop: shop 
produced: produced 
learn: learn 
king: king 
sense: sense 
niko: niko 
verse: verse 
happened: happened 
young: young 
recorded: recorded 
scholar: scholars 
tinted: tinted 
drake: drake 
raindrop: raindrops 
dot: dot 
viva: viva 
interpolation: interpolations 
spot: spot 
guess: guess 
quadeca: quadeca 
muserk: muserk 
film: film 
version: version 
entertainment: entertainment 
beat: beat 
timberlake: timberlake 
