clearance: clearances 
scar: scar 
fkn: fkn 
tradu: tradu 
important: important 
italic: italics 
iamjakehill: iamjakehill 
chorus: chorus 
section: section 
girl: girl girls 
nobody: nobody 
let: let 
deutsch: deutsch 
remixes: remixes 
thehxliday: thehxliday 
saghar: saghar 
released: released 
none: none 
traductions: traductions 
collection: collection 
tell: tell 
use: use 
svenska: svenska 
sadeyes: sadeyes 
lyric: lyrics lyric 
ttning: ttning 
give: give 
interest: interest 
starting: starting 
deus: deus 
guitar: guitar 
information: information 
yppah: yppah 
kale: kale 
w: w 
walk: walk 
world: world 
holding: holdings 
concert: concert 
eli: eli 
traduction: traduction 
presumably: presumably 
v: v 
daily: daily 
ha: ha 
doblel: doblel 
third: third 
back: back 
sky: sky 
much: much 
jackson: jackson 
york: york 
sickers: sickers 
privacy: privacy 
artist: artists 
want: want 
text: text 
write: write 
sodrac: sodrac 
loved: loved 
beat: beats beat 
impatient: impatient 
funny: funny 
care: cares 
another: another 
shout: shout 
eviri: eviri 
talk: talks 
answer: answer 
share: share 
bedroom: bedroom 
rip: rip 
mic: mic 
week: week 
never: never 
k: k 
grandfather: grandfather 
think: think 
guideline: guidelines 
ariozh: ariozh 
check: check 
song: song songs 
credit: credits 
awal: awal 
thru: thru 
deutsche: deutsche 
grim: grim 
melancholy: melancholy 
kryptik: kryptik 
irn: irn 
feature: features 
even: even 
happy: happy 
thing: thing 
deu: deu 
money: money 
everything: everything 
comment: comment comments 
commentary: commentary 
contributor: contributor contributors 
mom: mom 
actually: actually 
read: read 
mother: mother 
mess: mess 
lil: lil 
part: parts part 
header: headers 
right: right rights 
street: street 
ask: ask 
written: written 
performance: performance 
format: format 
vocalist: vocalists 
uploaded: uploaded 
developer: developers 
preach: preach 
emo: emo 
phonographic: phonographic 
pposture: pposture 
side: side 
fallin: fallin 
remix: remix 
due: due 
rk: rk 
sunday: sunday 
view: view 
become: become 
musical: musical 
visit: visit 
though: though 
created: created 
audiam: audiam 
p: p 
rotation: rotation 
duppy: duppy 
broken: broken 
different: different 
shine: shine 
remember: remember 
star: star stars 
ring: rings 
e: es e 
video: videos 
featured: featured 
tag: tags 
grant: grants 
issue: issue issues 
matter: matter 
ascap: ascap 
al: al 
got: got 
type: type 
b: b 
release: release 
lean: lean 
xemix: xemix 
sorted: sorted 
would: would 
bmi: bmi 
french: french 
earth: earth 
svensk: svensk 
x: x 
one: one 
feel: feels 
transcriber: transcribers 
night: night 
peace: peace 
via: via 
policy: policy 
publisher: publisher 
reason: reason 
alternative: alternative 
etc: etc 
sell: sell 
could: could 
friend: friends 
took: took 
fran: fran 
portugu: portugu 
annotation: annotation 
october: october 
broke: broke 
sht: sht 
told: told 
genius: genius 
im: im 
sample: samples sample 
tu: tu 
day: days 
press: press 
russian: russian 
rap: rap 
bersetzungen: bersetzungen 
gu: gus 
long: long 
emma: emma 
u: u us 
mornin: mornin 
verified: verified 
n: n 
caused: caused 
eklad: eklad 
g: g 
face: face 
help: help 
phone: phone 
blame: blame 
dum: dum 
knowledge: knowledge 
artwork: artwork 
talking: talking 
make: make 
f: ves f 
death: death 
helpin: helpin 
line: lines 
brasil: brasil 
licensing: licensing 
j: j 
german: german 
th: th 
aug: aug 
someone: someone 
chart: chart charts 
harris: harris 
italiane: italiane 
pump: pump 
say: say 
walnut: walnut 
efeito: efeito 
ol: ol 
losin: losin 
birthday: birthday 
forum: forum 
tonight: tonight 
traducciones: traducciones 
said: said 
advertise: advertise 
gwiazdy: gwiazdy 
ai: aises ais 
conversation: conversation 
add: add 
malone: malone 
nothing: nothing 
swedish: swedish 
august: august 
massimo: massimo 
fact: fact facts 
understand: understand 
guide: guide 
smallwasabi: smallwasabi 
persian: persian 
traduzione: traduzione 
need: needs 
weed: weed 
twitter: twitter 
promote: promote 
alternate: alternate 
kobalt: kobalt 
smokin: smokin 
copyright: copyright 
job: jobs 
biggest: biggest 
ny: ny 
bold: bold 
trip: trip 
wlex: wlex 
everyone: everyone 
unavailable: unavailable 
umaczenie: umaczenie 
composed: composed 
cover: cover covers 
contact: contact 
em: em 
turkish: turkish 
ml: ml 
officially: officially 
art: art 
mine: mine 
towards: towards 
attempting: attempting 
linarezzz: linarezzz 
also: also 
distributor: distributor 
get: get 
umaczenia: umaczenia 
scruffpuppie: scruffpuppie 
polski: polski 
reuben: reuben 
translation: translations translation 
traducci: traducci 
climbed: climbed 
cambridge: cambridge 
flexin: flexin 
peep: peep 
feeling: feelings feeling 
final: final 
pericolo: pericolo 
bersetzung: bersetzung 
comin: comin 
tribute: tribute 
cancel: cancel 
trap: trap 
patience: patience 
z: z 
high: high 
record: record 
artbychase: artbychase 
resurgence: resurgence 
way: way 
least: least 
new: new 
mej: mej 
look: look 
made: made 
keepin: keepin 
top: top 
piece: pieces 
heroin: heroin 
term: terms 
popularity: popularity 
east: east 
streaming: streaming 
polskie: polskie 
open: open 
morgan: morgan 
interpolate: interpolate 
whopper: whopper 
latinautor: latinautor 
bipolar: bipolar 
hvrvest: hvrvest 
relax: relax 
comfortable: comfortable 
aise: aise 
embed: embed 
first: first 
bugzy: bugzy 
luckhaos: luckhaos 
ft: ft 
worth: worth 
time: time 
wait: wait 
sun: sun 
arshia: arshia 
hot: hot 
farsi: farsi 
ultimate: ultimate 
zachariah: zachariah 
receive: receive 
like: like 
waist: waist 
distinguish: distinguish 
makin: makin 
esk: esk 
aways: aways 
diego: diego 
fuck: fuck 
waitin: waitin 
commitment: commitment 
medlin: medlin 
source: source 
rebel: rebel 
sign: sign 
q: q 
half: half 
centered: centered 
sea: sea 
minnesota: minnesota 
r: r 
joseph: joseph 
minute: minutes 
spanish: spanish 
asked: asked 
dia: dia 
llc: llc 
insight: insight 
always: always 
expand: expand 
worse: worse 
sad: sad 
satan: satan 
waste: waste 
april: april 
talkin: talkin 
slum: slum 
portuguese: portuguese 
repeating: repeating 
dark: dark 
track: track 
winnchester: winnchester 
love: love 
app: app 
boosted: boosted 
find: find 
someday: someday 
family: family 
unreleased: unreleased 
understands: understands 
work: work 
ex: exes 
ne: ne 
date: date 
c: c 
voice: voices 
relationship: relationship 
h: h 
individual: individual 
service: services 
certification: certifications 
cause: cause 
know: know 
perfect: perfect 
personal: personal 
note: notes 
transcription: transcription 
might: might 
entered: entered 
gone: gone 
yeah: yeah 
claiming: claiming 
sadinsky: sadinsky 
tathan: tathan 
pick: pick 
vocal: vocals 
esky: esky 
ppl: ppl 
beach: beach 
however: however 
italian: italian 
music: music 
l: l 
really: really 
longer: longer 
live: live 
slowly: slowly 
crowd: crowd 
dyscaine: dyscaine 
question: question 
drop: drop 
shop: shop 
espa: espa 
produced: produced 
learn: learn 
shinkaku: shinkaku 
negotiation: negotiation 
verse: verse 
informs: informs 
recorded: recorded 
gorgeous: gorgeous 
italiana: italiana 
calendario: calendario 
tvrp: tvrp 
scholar: scholars 
ripped: ripped 
centerpiece: centerpiece 
shopping: shopping 
par: par 
version: version 
ka: ka 
traduzioni: traduzioni 
hatin: hatin 
italiano: italiano 
abramus: abramus 
