beard: beard 
atlantic: atlantic 
cobra: cobra 
fuyang: fuyang 
ebony: ebony 
shapiro: shapiro 
talk: talk 
tradu: tradu 
foreign: foreign 
du: du 
hang: hang 
woo: woo 
bitch: bitch 
italic: italics 
freak: freak 
secret: secrets secret 
around: around 
keyz: keyz 
chorus: chorus 
dive: dive 
section: section 
halloween: halloween 
girl: girl 
nederlandse: nederlandse 
stank: stank 
kiss: kiss 
let: let 
marc: marc 
nigga: nigga 
empowerment: empowerment 
deutsch: deutsch 
mili: mili 
imanbek: imanbek 
anti: anti 
remixes: remixes 
smoker: smoker 
brii: brii 
little: little 
mark: marks mark 
elise: elise 
traductions: traductions 
rapidsongs: rapidsongs 
leonard: leonard 
collection: collection 
liberation: liberation 
tell: tell 
janice: janice 
use: use 
heard: heard 
logan: logan 
kenn: kenn 
lyric: lyrics lyric 
touch: touch 
ryancomedy: ryancomedy 
give: give 
needymoon: needymoon 
deep: deep 
heavy: heavy 
outro: outro 
grammy: grammy 
put: put 
dasani: dasani 
information: information 
sampaio: sampaio 
demo: demo 
freemix: freemix 
cypher: cypher 
arianator: arianator 
boy: boy 
aiden: aiden 
explicit: explicit 
certified: certified 
charting: charting 
nihmune: nihmune 
w: w 
world: world 
scream: scream 
holding: holdings 
fziro: fziro 
traduction: traduction 
goin: goin 
v: v 
baby: baby 
ign: ign 
whore: whores 
vertaling: vertaling 
back: back 
mouth: mouth 
cardi: cardi 
wanna: wanna 
jackson: jackson 
ty: ty 
kandie: kandie 
glasser: glasser 
tuition: tuition 
prod: prod 
tan: tan 
kurt: kurt 
privacy: privacy 
hope: hope 
want: want 
artist: artists 
rinat: rinat 
ayy: ayy 
pow: pow 
bout: bout 
carter: carter 
uma: uma 
blinding: blinding 
pov: pov 
funny: funny 
another: another 
baddie: baddie 
kollin: kollin 
color: color 
dick: dick 
run: run 
eviri: eviri 
progressed: progressed 
earworm: earworm 
answer: answer 
share: share 
stallion: stallion 
liu: liu 
mic: mic 
message: message 
week: week 
never: never 
second: second 
garage: garage 
k: k 
snake: snake 
tilley: tilley 
nychelle: nychelle 
guideline: guidelines 
name: name 
herby: herby 
check: check 
song: song songs 
fivio: fivio 
credit: credits credit 
comet: comet 
corn: corn 
deutsche: deutsche 
cupcakke: cupcakke 
talbot: talbot 
man: man 
street: streets 
rugged: rugged 
mashups: mashups 
sbpt: sbpt 
even: even 
engineer: engineer 
garter: garter 
happy: happy 
peasant: peasants 
thing: thing 
parsnip: parsnip 
von: von 
sica: sica 
eat: eat 
everything: everything 
money: money 
punani: punani 
shawn: shawn 
freestyl: freestyl 
comment: comment comments 
gulp: gulp 
demeanor: demeanor 
hardcore: hardcore 
coat: coat 
romanian: romanian 
dangly: dangly 
knee: knees 
contributor: contributor contributors 
yung: yung 
read: read 
word: word 
lil: lil 
english: english 
savage: savage 
part: parts part 
past: past 
header: headers 
right: right rights 
ask: ask 
written: written 
performance: performance performances 
disguise: disguise 
format: format 
triple: triple 
breaking: breaking 
vocalist: vocalists 
scene: scenes scene 
cupid: cupid 
ah: ah 
south: south 
developer: developers 
child: childs 
appearing: appearing 
inutilismo: inutilismo 
rom: rom 
twin: twins twin 
farshad: farshad 
collaboration: collaboration 
reapz: reapz 
bmg: bmg 
wapsody: wapsody 
gotit: gotit 
phonographic: phonographic 
hoy: hoy 
director: director 
lung: lung 
fore: fore 
side: side 
remix: remix 
abortalex: abortalex 
whap: whap 
magazine: magazine 
pull: pull 
rk: rk 
mixing: mixing 
view: view 
musical: musical 
visit: visit 
created: created 
billboard: billboard 
game: game 
truck: truck 
shit: shit 
throat: throat 
studio: studio 
jam: jam 
head: head 
p: p 
vinnie: vinnie 
see: see 
schneider: schneider 
month: months 
hook: hook 
holup: holup 
broken: broken 
different: different 
jamee: jamee 
sings: sings 
united: united 
whose: whose 
bought: bought 
fight: fight 
hitter: hitter 
arabic: arabic 
park: park 
pardison: pardison 
elia: elias 
fontaine: fontaine 
creatives: creatives 
clyro: clyro 
sexual: sexual 
enagonio: enagonio 
e: es e 
video: videos video 
pussy: pussy 
featured: featured 
album: album 
taylor: taylor 
tag: tags 
ride: ride 
biffy: biffy 
label: label 
evan: evan 
reaching: reaching 
faygo: faygo 
parody: parody 
today: today 
hol: hol 
looping: looping 
ascap: ascap 
al: al 
rockstar: rockstar 
luvi: luvi 
wap: wap 
surprised: surprised 
got: got 
coast: coast 
tryna: tryna 
handcuff: handcuffs 
clean: clean 
type: type 
lip: lip 
mojao: mojao 
b: b 
release: release 
lean: lean 
instasamka: instasamka 
knight: knight 
misali: misali 
pot: pot 
waptopia: waptopia 
controversy: controversy 
boot: boots 
group: group 
swallow: swallow 
jump: jump 
skillibeng: skillibeng 
ricch: ricch 
traducere: traducere 
would: would 
bmi: bmi 
announcement: announcement 
intro: intro 
french: french 
inc: inc 
boe: boe 
nature: nature 
x: x 
one: one 
paradise: paradise 
pair: pair 
transcriber: transcribers 
wild: wild 
night: night 
elevate: elevate 
honor: honor 
lardi: lardi 
received: received 
priscie: priscie 
according: according 
gag: gag 
box: box 
pedro: pedro 
policy: policy 
publisher: publisher 
future: future 
production: productions production 
pancake: pancakes 
etc: etc 
sell: sell 
could: could 
creative: creative 
fran: fran 
texas: texas 
portugu: portugu 
cheatin: cheatin 
flighty: flighty 
edit: edit 
midnight: midnight 
wolf: wolves 
revive: revive 
click: click 
annotation: annotation 
perform: perform 
liddell: liddell 
broke: broke 
company: company 
soggy: soggy 
brega: brega 
alongside: alongside 
best: best 
debuted: debuted 
woah: woah 
ben: ben 
dudley: dudley 
henny: henny 
later: later 
genius: genius 
nick: nick 
thouxanbanfauni: thouxanbanfauni 
somethin: somethin 
seren: seren 
tsui: tsui 
maranci: maranci 
lost: lost 
frog: frog 
vida: vida 
sample: samples sample 
featuring: featuring 
day: days day 
press: press 
russian: russian 
club: club 
freestyle: freestyle 
mind: mind 
latte: latte 
necat: necat 
liv: liv 
rap: rap 
mop: mop 
choreographer: choreographer 
rogers: rogers 
beatin: beatin 
bersetzungen: bersetzungen 
light: lights 
srpski: srpski 
keyzbaby: keyzbaby 
stand: stand 
yg: yg 
tiktok: tiktok 
u: u us 
believe: believe 
verified: verified 
raunchy: raunchy 
hit: hits hit 
n: n 
female: female 
network: network 
number: number 
g: g 
face: face 
macaroni: macaroni 
bab: bab 
brockhamptonleaks: brockhamptonleaks 
phone: phone 
bucket: bucket 
prevod: prevod 
midwxst: midwxst 
hyphy: hyphy 
knowledge: knowledge 
kartel: kartel 
wab: wab 
seven: seven 
patientce: patientce 
large: large 
make: make 
ar: ar 
dream: dream 
death: death 
online: online 
line: lines 
brasil: brasil 
licensing: licensing 
unotheactivist: unotheactivist 
j: j 
german: german 
sony: sony 
yo: yo 
na: na 
brathwaite: brathwaite 
nederland: nederlands 
vertalingen: vertalingen 
preta: preta 
thomas: thomas 
oliver: oliver 
multifemale: multifemale 
ol: ol 
fashion: fashion 
moonie: moonies 
quick: quick 
forum: forum 
lookin: lookin 
traducciones: traducciones 
chat: chat 
woman: women 
said: said 
inside: inside 
ffm: ffm 
advertise: advertise 
siren: siren 
editor: editor 
ai: aises ais 
meet: meet 
closet: closet 
built: built 
add: add 
widow: widow 
foster: foster 
august: august 
cosmic: cosmic 
fact: fact facts 
understand: understand 
jarrett: jarrett 
guide: guide 
rain: rain 
wet: wet 
drip: drip 
react: react 
break: break 
toto: toto 
weed: weed 
kegel: kegel 
funk: funk 
please: please 
ranta: ranta 
pullout: pullout 
washpoppin: washpoppin 
nose: nose 
vanhstp: vanhstp 
bhleaks: bhleaks 
royalty: royalty 
promote: promote 
alternate: alternate 
hip: hip 
destroy: destroy 
copyright: copyright 
job: jobs 
biggest: biggest 
bite: bite 
bold: bold 
knowles: knowles 
f: f 
bottom: bottom 
photography: photography 
cover: cover covers 
tie: tie 
contact: contact 
melanie: melanie 
em: em 
turkish: turkish 
extra: extra 
state: state 
casa: casa 
ml: ml 
ate: ate 
card: card 
jan: jan 
terminal: terminal 
ayo: ayo 
also: also 
distributor: distributor 
eye: eyes 
get: get 
runnin: runnin 
came: came 
mclaran: mclaran 
stroker: stroker 
translation: translations translation 
whate: whate 
butter: butter 
sex: sex 
paid: paid 
gwuap: gwuap 
friend: friend 
slow: slow 
traducci: traducci 
carthi: carthi 
feeling: feelings 
bersetzung: bersetzung 
peeeeee: peeeeee 
comin: comin 
worldwide: worldwide 
abushaev: abushaev 
delli: delli 
dutch: dutch 
achievement: achievement 
normani: normani 
mood: mood 
bring: bring 
cancel: cancel 
gr: gr 
trap: trap 
dirty: dirty 
mwah: mwah 
minoy: minoy 
choke: choke 
controversial: controversial 
record: record records 
holy: holy 
come: come 
singe: singe 
leash: leashes 
ply: plies 
hardest: hardest 
whitney: whitney 
wear: wear 
mastering: mastering 
gobble: gobble 
cream: cream 
worried: worried 
headed: headed 
look: look 
brandon: brandon 
made: made 
snapped: snapped 
top: top 
montana: montana 
macei: macei 
jaquel: jaquel 
mix: mix 
diabetic: diabetic 
term: terms 
sola: sola 
nd: nd 
east: east 
bardcore: bardcore 
levitating: levitating 
take: take 
hoe: hoes 
interpolate: interpolate 
chain: chain 
roth: roth 
hop: hop 
picture: pictures 
widely: widely 
sqwoz: sqwoz 
la: la 
aise: aise 
embed: embed 
first: first 
bohemian: bohemian 
bang: bang 
detail: detail 
thang: thang 
avex: avex 
universal: universal 
ft: ft 
time: time 
ever: ever 
hot: hot 
three: three 
castle: castle 
nihmussy: nihmussy 
kidd: kidd 
since: since 
well: well 
ultimate: ultimate 
william: william 
pee: pee 
vitamin: vitamin 
string: string 
fourth: fourth 
like: like 
distinguish: distinguish 
serbian: serbian 
sight: sights 
ayce: ayce 
z: z 
benjamin: benjamin 
hurt: hurt 
wig: wig 
fuck: fuck 
huh: huh 
drinker: drinker 
thee: thee 
frank: frank 
source: source 
youngmani: youngmani 
need: need 
miranda: miranda 
sign: sign 
q: q 
waa: waa 
pop: pop 
waw: waw 
r: r 
quartet: quartet 
colin: colin 
cameo: cameo 
alessandro: alessandro 
spanish: spanish 
asked: asked 
equinox: equinox 
bass: bass 
llc: llc 
official: official 
theriannightcore: theriannightcore 
larinhx: larinhx 
poofesure: poofesure 
award: awards 
dry: dry 
insight: insight 
yungpalma: yungpalma 
feeder: feeder 
ya: ya 
fantasy: fantasies 
damienfarron: damienfarron 
expand: expand 
traduceri: traduceri 
big: big 
fama: fama 
smokeyy: smokeyy 
itsjosh: itsjosh 
feel: feel 
pain: pain 
spell: spell 
megan: megan 
talkin: talkin 
hnm: hnm 
portuguese: portuguese 
already: already 
swipe: swipe 
repeating: repeating 
expected: expected 
premiere: premiere 
exist: exist 
sound: sounds 
track: track 
upperclassmen: upperclassmen 
christian: christian 
smokey: smokey 
revealed: revealed 
love: love 
public: public 
roddy: roddy 
hotspot: hotspot 
behind: behind 
publishing: publishing 
sam: sam 
kxros: kxros 
date: date 
food: food 
ex: ex 
sap: sap 
c: c 
rodriguez: rodriguez 
house: house 
megamix: megamix 
hugo: hugo 
fast: fast 
saturn: saturn 
heidi: heidi 
ski: ski 
burning: burning 
mashup: mashup 
weak: weak 
h: h 
waples: waples 
individual: individual 
certification: certifications 
roleplay: roleplay 
single: single 
prevodi: prevodi 
shoot: shoot 
taste: taste 
edenwasthere: edenwasthere 
know: know 
perreo: perreo 
solo: solo 
rob: rob 
heart: heart 
personal: personal 
pikachu: pikachu 
swing: swing 
haw: haw 
transcription: transcription 
chart: charts 
might: might 
chinese: chinese 
hard: hard 
yeah: yeah 
laray: laray 
charge: charge 
malacaria: malacaria 
lift: lift 
warner: warner 
catch: catch 
soulja: soulja 
brother: brother 
switch: switch 
however: however 
music: music 
raxelle: raxelle 
qveen: qveen 
rose: roses 
really: really 
l: l 
beedle: beedle 
bust: bust 
falling: falling 
live: live 
cop: cops 
question: question 
nigel: nigel 
producer: producer 
waffle: waffles 
something: something 
drop: drop 
gotta: gotta 
sparked: sparked 
shop: shop 
espa: espa 
lady: lady 
produced: produced 
learn: learn 
zedd: zedd 
appear: appear 
spit: spit 
king: king 
ring: ring 
car: car 
alizade: alizade 
verse: verse 
dripspot: dripspot 
positive: positive 
executive: executive 
blueberry: blueberry 
dj: dj 
value: values 
moti: moti 
scholar: scholars 
fire: fire 
laxed: laxed 
cook: cook 
hobbs: hobbs 
viva: viva 
praised: praised 
fuckin: fuckin 
interpolation: interpolations 
story: story 
armed: armed 
as: ass 
gz: gz 
version: version 
vybz: vybz 
upcoming: upcoming 
entertainment: entertainment 
mack: mack 
beat: beat 
physical: physical 
sulan: sulan 
leslie: leslie 
dolla: dolla 
rola: rola 
