damn: damn 
italic: italics 
bitch: bitch 
karma: karma 
bread: bread 
alaich: alaich 
around: around 
chorus: chorus 
tj: tj 
still: still 
section: section 
girl: girl girls 
february: february 
nigga: nigga niggas 
blessing: blessings 
anything: anything 
good: good 
roc: roc 
wane: wane 
remixes: remixes 
pour: pour 
little: little 
released: released 
sacramento: sacramento 
collection: collection 
tell: tell 
nitin: nitin 
use: use 
doe: doe 
fallon: fallon 
heard: heard 
bird: bird 
corp: corp 
lyric: lyrics lyric 
bad: bad 
wakin: wakin 
give: give 
forget: forget 
outro: outro 
deep: deep 
heavy: heavy 
put: put 
doin: doin 
uknowbigsean: uknowbigsean 
information: information 
boy: boy 
certified: certified 
crazy: crazy 
w: w 
world: world 
holding: holdings 
rick: rick 
goin: goin 
v: v 
ha: ha 
sky: sky 
back: back 
mouth: mouth 
bme: bme 
rat: rat 
wake: wake 
privacy: privacy 
hope: hope 
want: want 
text: text 
artist: artists 
pimp: pimp 
care: care 
loved: loved 
go: go goes 
another: another 
ca: ca 
earworm: earworm 
answer: answer 
thinkin: thinkin 
share: share 
shade: shades 
never: never 
sonata: sonata 
k: k 
co: co 
guideline: guidelines 
kanskaart: kanskaart 
name: name 
check: check 
song: song songs 
credit: credits 
ezale: ezale 
trillion: trillion 
man: man 
appearance: appearance 
blackwood: blackwood 
even: even 
engineer: engineer 
extended: extended 
grind: grind 
shoulda: shoulda 
post: post 
rich: rich 
liar: liar 
everything: everything 
real: real 
ii: ii 
comment: comment comments 
fetti: fetti 
mmm: mmm 
wrote: wrote 
contributor: contributor contributors 
read: read 
hawoo: hawoo 
lil: lil 
meme: memes 
underground: underground 
meditatin: meditatin 
riaa: riaa 
free: free 
part: parts part 
next: next 
header: headers 
ask: ask 
written: written 
performance: performance 
format: format 
vocalist: vocalists 
miguel: miguel 
service: service 
south: south 
trill: trill 
developer: developers 
outside: outside 
erykah: erykah 
pecf: pecf 
stuck: stuck 
elevator: elevator 
september: september 
mustard: mustard 
side: side 
remix: remix 
magazine: magazine 
mixing: mixing 
view: view 
musical: musical 
visit: visit 
specifically: specifically 
created: created 
billboard: billboard 
shit: shit 
nef: nef 
studio: studio studios 
jam: jam 
print: print 
p: p 
pic: pic 
play: play 
killed: killed 
see: see 
uh: uh 
chase: chase 
medium: media 
swizole: swizole 
breakin: breakin 
platz: platz 
eternity: eternity 
broken: broken 
different: different 
united: united 
bill: bill 
bought: bought 
chasin: chasin 
rock: rock 
drama: drama 
tone: tone 
video: videos video 
story: stories story 
philthy: philthy 
win: win 
casablanca: casablanca 
featured: featured 
cool: cool 
album: album 
tag: tags 
nothin: nothin 
grant: grants 
label: label 
ascap: ascap 
key: key 
takin: takin 
got: got 
ozone: ozone 
coast: coast 
tryna: tryna 
obd: obd 
drinkin: drinkin 
type: type 
whip: whip 
bullshit: bullshit 
release: release 
b: b 
yup: yup 
mp: mp 
right: rights 
askin: askin 
group: group 
domeless: domeless 
rollin: rollin 
bay: bay 
chick: chick 
hear: hear 
bmi: bmi 
announcement: announcement 
intro: intro 
french: french 
earth: earth 
randhawa: randhawa 
brr: brr 
x: x 
paradise: paradise 
one: one 
bullet: bullet 
transcriber: transcribers 
night: night 
following: following 
rivera: rivera 
lot: lot 
received: received 
barely: barely 
com: com 
raise: raise 
naya: naya 
via: via 
policy: policy 
cheddar: cheddar 
publisher: publisher 
tamerlane: tamerlane 
production: productions 
slim: slim 
biatch: biatch 
etc: etc 
sell: sell 
could: could 
lose: lose 
tob: tob 
annotation: annotation 
county: county 
bet: bet 
along: along 
best: best 
woah: woah 
dahi: dahi 
jaeger: jaeger 
david: david 
chromeless: chromeless 
dripdemeanor: dripdemeanor 
wood: wood 
thank: thank 
genius: genius 
sample: samples sample 
featuring: featuring 
choosin: choosin 
press: press 
research: research 
mind: mind 
rap: rap 
styrofoam: styrofoam 
swerve: swerve 
blowin: blowin 
rogers: rogers 
pt: pt 
mike: mike 
title: title 
idfwy: idfwy 
stand: stand 
forever: forever 
sayitaintone: sayitaintone 
u: u us 
verified: verified 
codi: codi 
n: n 
g: g 
pharaoh: pharaoh 
phone: phone 
futuristic: futuristic 
room: room 
sum: sum 
knowledge: knowledge 
every: every 
mitten: mitten 
sesac: sesac 
make: make makes 
seem: seem 
west: west 
sign: signs sign 
death: death 
online: online 
mojo: mojo 
line: lines 
licensing: licensing 
j: j 
sony: sony 
life: life 
th: th 
chart: chart charts 
gimme: gimme 
sean: sean 
amount: amount 
decision: decision 
chu: chu 
cent: cents 
say: say 
change: change 
quick: quick 
aw: aw 
forum: forum 
late: late 
content: content 
mad: mad 
advertise: advertise 
additional: additional 
add: add 
game: games 
crew: crew 
limited: limited 
wind: wind 
understand: understand 
hella: hella 
rather: rather 
guide: guide 
history: history 
swear: swear 
break: break 
weed: weed 
please: please 
timberlake: timberlake 
trilogy: trilogy 
promote: promote 
hip: hip 
kobalt: kobalt 
job: jobs 
copyright: copyright 
biggest: biggest 
dogg: dogg 
bold: bold 
f: f 
crib: crib 
rest: rest 
chappell: chappell 
contact: contact 
fault: fault 
dental: dental 
state: state 
ml: ml 
celebratin: celebratin 
recording: recordings recording 
towards: towards 
also: also 
get: get 
mean: mean 
management: management 
conscience: conscience 
feeling: feelings 
harley: harley 
wit: wit 
lit: lit 
nation: nation 
comin: comin 
fact: facts 
end: end 
def: def 
thing: things 
casino: casino 
ho: ho 
statue: statue 
cancel: cancel 
z: z 
elliott: elliott 
come: come 
way: way 
emi: emi 
mgm: mgm 
liberty: liberty 
new: new 
givin: givin 
missy: missy 
made: made 
top: top 
annuity: annuity 
callin: callin 
montana: montana 
mix: mix 
term: terms 
hoe: hoes 
take: take 
interpolate: interpolate 
whopper: whopper 
god: god 
hop: hop 
badu: badu 
keep: keep 
embed: embed 
kmr: kmr 
first: first 
mmg: mmg 
universal: universal 
grade: grade 
ft: ft 
time: time 
last: last 
rominiecki: rominiecki 
blunt: blunt 
complex: complex 
fine: fine 
hot: hot 
three: three 
sharaya: sharaya 
ultimate: ultimate 
fourth: fourth 
like: like 
distinguish: distinguish 
holliday: holliday 
million: million 
makin: makin 
cover: covers 
two: two 
himalaya: himalayas 
superfruit: superfruit 
kanye: kanye 
fuck: fuck 
huh: huh 
snoop: snoop 
sick: sick 
signed: signed 
angeles: angeles 
source: source 
need: need 
justin: justin 
q: q 
day: day 
stay: stay 
r: r 
pop: pop 
chongo: chongo 
arsenio: arsenio 
kahoot: kahoot 
llc: llc 
jimmy: jimmy 
ross: ross 
royalty: royalties 
insight: insight 
deserve: deserve 
ya: ya 
e: e 
prison: prison 
memory: memory 
usa: usa 
always: always 
expand: expand 
big: big 
deluxe: deluxe 
feel: feel 
skyscraper: skyscrapers 
ceiling: ceilings 
los: los 
repeating: repeating 
dark: dark 
track: track 
atv: atv 
til: til 
love: love 
find: find 
dodged: dodged 
publishing: publishing 
sam: sam 
date: date 
floor: floor 
platinum: platinum 
c: c 
relationship: relationship 
jennifer: jennifer 
straight: straight 
reached: reached 
shinigami: shinigami 
stupid: stupid 
h: h 
individual: individual 
unconscious: unconscious 
scsp: scsp 
liable: liable 
certification: certifications 
cause: cause 
buildin: buildin 
single: single 
dollar: dollar 
property: property 
everybody: everybody 
mission: missions 
four: four 
know: know 
rob: rob 
heart: heart 
personal: personal 
maloles: maloles 
transcription: transcription 
might: might 
hard: hard 
deal: deals 
pre: pre 
homeless: homeless 
yeah: yeah 
sentimental: sentimental 
dis: diss 
canadiana: canadiana 
dumb: dumb 
warner: warner 
record: records 
rental: rental 
kinelski: kinelski 
brain: brain 
l: l 
music: music 
really: really 
news: news 
broadway: broadway 
maximilian: maximilian 
question: question 
orange: orange 
clothes: clothes 
producer: producer 
drop: drop 
gotta: gotta 
shop: shop 
produced: produced 
learn: learn 
king: king 
murder: murder 
verse: verse 
recorded: recorded 
executive: executive 
hemp: hemp 
gun: guns 
dj: dj 
administration: administration 
card: cards 
scholar: scholars 
fire: fire 
fuckin: fuckin 
nowadays: nowadays 
guess: guess 
as: ass 
version: version 
gregg: gregg 
entertainment: entertainment 
jay: jay 
beat: beat 
drink: drink 
silly: silly 
