recurring: recurring 
foreign: foreign 
limon: limon 
famous: famous 
italic: italics 
bitch: bitch 
trippythakid: trippythakid 
vendo: vendo 
around: around 
chorus: chorus 
momo: momo 
tj: tj 
still: still 
sage: sage 
section: section 
time: times time 
girl: girl girls 
robinbod: robinbod 
dakooters: dakooters 
disscord: disscord 
throughout: throughout 
ad: ad 
anything: anything 
vesi: vesi 
pieo: pieo 
baker: baker 
deutsch: deutsch 
urdu: urdu 
ard: ard 
bhad: bhad 
remixes: remixes 
seppli: seppli 
carry: carry 
denov: denov 
zero: zero 
te: te 
kyle: kyle 
merkules: merkules 
released: released 
stunner: stunners 
none: none 
collection: collection 
easy: easy 
ybn: ybn 
oczosinko: oczosinko 
nitin: nitin 
use: use 
dame: dame 
lyric: lyrics lyric 
bad: bad 
westjet: westjet 
xxxbi: xxxbi 
deep: deep 
esskeetit: esskeetit 
information: information 
rapper: rapper rappers 
mei: mei 
boy: boy boys 
kale: kale 
po: po 
telnor: telnor 
killer: killers 
crazy: crazy 
w: w 
flocka: flocka 
scream: scream 
davidson: davidson 
taco: taco 
world: world 
holding: holdings 
de: de 
independent: independent 
debuting: debuting 
v: v 
baby: baby 
momma: momma 
morges: morges 
tech: tech 
soundclown: soundclown 
drug: drugs 
bunny: bunny 
back: back 
versace: versace 
bent: bent 
vilan: vilan 
phil: phil 
jackson: jackson 
giving: giving 
jewelry: jewelry 
acrylo: acrylo 
doxera: doxera 
privacy: privacy 
artist: artists 
yes: yes 
pinch: pinch 
ayy: ayy 
fizzle: fizzle 
boogie: boogie 
rap: raps rap 
care: care 
token: token 
evaristobeatbox: evaristobeatbox 
loved: loved 
go: go 
groupie: groupie 
monika: monika 
keeb: keeb 
waka: waka 
funny: funny 
buy: buy 
joyner: joyner 
gully: gully 
ear: ears 
skinny: skinny 
ca: ca 
komrade: komrade 
banger: banger 
eviri: eviri 
answer: answer 
multi: multi 
share: share 
literature: literature 
gang: gang 
spend: spend 
nope: nope 
except: except 
k: k 
tim: tim 
wicked: wicked 
guideline: guidelines 
name: name 
ouu: ouu 
check: check 
song: song songs 
streamer: streamer 
credit: credits 
whoa: whoa 
deutsche: deutsche 
cristo: cristo 
tucci: tucci 
gu: gu 
wayne: wayne 
yoshi: yoshi 
killumantii: killumantii 
dinner: dinner 
smokepurpp: smokepurpp 
even: even 
engineer: engineer 
dime: dime 
mill: mill 
instrumental: instrumental 
dad: dad dads 
battts: battts 
liar: liar 
onedaygaming: onedaygaming 
money: money 
roblox: roblox 
hole: hole 
percocet: percocet 
offshore: offshore 
real: real 
cig: cig 
comment: comment comments 
speech: speech 
contributor: contributor contributors 
yung: yung 
callmecake: callmecake 
read: read 
iced: iced 
ringer: ringer 
lil: lil 
english: english 
savage: savage 
part: parts part 
goat: goat goats 
ch: ch 
header: headers 
right: right rights 
batty: batty 
jack: jack 
ask: ask 
written: written 
performance: performance 
dubleaadank: dubleaadank 
fucci: fucci 
format: format 
chromatic: chromatic 
vocalist: vocalists 
westwood: westwood 
service: service 
vinagang: vinagang 
miguel: miguel 
developer: developers 
tent: tent 
rom: rom roma 
cigarette: cigarettes 
dawoodsavage: dawoodsavage 
sech: sech 
goody: goody 
lou: lou 
jhayco: jhayco 
ballin: ballin 
director: director 
peppa: peppa 
saturday: saturday 
remix: remix 
theslicingsword: theslicingsword 
yelawolf: yelawolf 
er: er 
jexf: jexf 
mixing: mixing 
burnt: burnt 
rice: rice 
blaz: blaz 
rk: rk 
view: view 
pepsi: pepsi 
private: private 
musical: musical 
visit: visit 
rkiye: rkiye 
runt: runts 
created: created 
billboard: billboard 
shit: shit 
tri: tri 
game: game 
cocaine: cocaine 
return: return 
theme: theme 
head: head 
shaq: shaq 
p: p 
ooh: ooh 
talhah: talhah 
wearing: wearing 
mane: mane 
call: call 
pretender: pretender 
broken: broken 
different: different 
sings: sings 
czech: czech 
gangue: gangue 
cost: cost 
bought: bought 
ridhwan: ridhwan 
fight: fight 
bright: bright 
vida: vida 
howe: howe 
park: park 
neithan: neithan 
feby: feby 
red: red 
video: videos video 
est: est 
pussy: pussy 
kobe: kobe 
featured: featured 
tag: tags 
bart: bart 
balmains: balmains 
label: label 
mc: mc 
parody: parody 
mascka: mascka 
jeezy: jeezy 
water: water 
lan: lan 
michael: michael 
sushi: sushi 
maneyx: maneyx 
gawne: gawne 
appeared: appeared 
ascap: ascap 
al: al 
emis: emis 
veslelia: veslelia 
bigger: bigger 
beckendorf: beckendorf 
type: type 
release: release 
b: b 
lean: lean 
monte: monte 
py: py 
minecraft: minecraft 
rack: racks 
mp: mp 
screamed: screamed 
cypress: cypress 
group: group 
would: would 
bmi: bmi 
together: together 
mining: mining 
intro: intro 
ozuna: ozuna 
french: french 
inc: inc 
total: total 
randhawa: randhawa 
brr: brr 
nder: nder 
eesti: eesti 
miraie: miraie 
x: x 
ramon: ramon 
one: one 
transcriber: transcribers 
peaking: peaking 
undertaker: undertaker 
night: night 
pleshka: pleshka 
ti: ti 
booty: booty 
eddy: eddy 
fmrs: fmrs 
krabby: krabby 
vuxvux: vuxvux 
matu: matu 
sandwich: sandwich 
le: le 
policy: policy 
prime: prime 
boonk: boonk 
publisher: publisher 
cu: cu 
leaker: leakers 
production: productions production 
ten: ten 
nork: nork 
sell: sell 
etc: etc 
anjum: anjum 
greg: greg 
pulled: pulled 
astra: astra 
trigger: trigger 
luffy: luffy 
ryo: ryo 
vex: vex 
rockwell: rockwell 
annotation: annotation 
used: used 
yro: yro 
senzawa: senzawa 
mec: mec 
mega: mega 
bi: bi 
october: october 
russia: russia 
company: company 
daymanoursavior: daymanoursavior 
bank: bank 
morgenshtern: morgenshtern 
polish: polish 
ben: ben 
giant: giant 
tank: tank 
tussi: tussi 
thank: thank 
genius: genius 
igu: igu 
sample: samples sample 
featuring: featuring 
tu: tu 
fry: fry 
simply: simply 
press: press 
kuzi: kuzi 
russian: russian 
club: club 
performed: performed 
freestyle: freestyle 
sound: sound 
adios: adios 
siri: siri 
pt: pt 
bersetzungen: bersetzungen 
light: lights 
major: major 
cage: cage 
santa: santa 
ninja: ninja 
mads: mads 
clothing: clothing 
else: else 
oguem: oguem 
u: u us 
mama: mama 
verified: verified 
n: n 
g: g 
grandma: grandma 
chan: chan 
futuristic: futuristic 
ueli: ueli 
forbes: forbes 
knowledge: knowledge 
azman: azman 
deemz: deemz 
wedding: wedding 
eladio: eladio 
make: make 
ar: ar 
esketit: esketit 
west: west 
bussy: bussy 
death: death 
krzysztof: krzysztof 
line: lines 
gold: gold 
unotheactivist: unotheactivist 
j: j 
licensing: licensing 
german: german 
baggage: baggage 
throw: throw 
yo: yo 
laude: laude 
griffin: griffin 
th: th 
provost: provost 
chart: chart charts 
warning: warning 
ctrl: ctrl 
menchie: menchie 
pump: pump 
doce: doce 
izi: izi 
suchodolski: suchodolski 
goodwill: goodwill 
say: say says 
efeito: efeito 
quem: quem 
ol: ol 
plane: plane 
noir: noir 
forum: forum 
traducciones: traducciones 
molly: molly 
woman: women 
tye: tye 
zap: zap 
ffm: ffm 
advertise: advertise 
marvel: marvel 
kononowicz: kononowicz 
many: many 
man: mans 
campa: campa 
add: add 
poo: poo 
knuckle: knuckles 
august: august 
dmc: dmc 
strong: strong 
bk: bk 
shaun: shaun 
ugandan: ugandan 
understand: understand 
florida: florida 
hella: hella 
rather: rather 
guide: guide 
wet: wet 
successful: successful 
inzei: inzei 
kurby: kurby 
psychopieo: psychopieo 
kushtem: kushtem 
richchoi: richchoi 
rose: rose 
school: school 
project: projects 
promote: promote 
jet: jets jet 
pinky: pinky 
kobalt: kobalt 
frrresh: frrresh 
job: jobs 
biggest: biggest 
copyright: copyright 
prata: prata 
bold: bold 
yuh: yuh 
sl: sl 
cof: cof 
apandah: apandah 
f: f 
everyone: everyone 
acoustic: acoustic 
shank: shank 
smb: smb 
adoboys: adoboys 
cover: cover covers 
larun: larun 
lucas: lucas 
umaczenie: umaczenie 
crib: crib 
bohemia: bohemia 
en: en 
contact: contact 
buford: buford 
hemingway: hemingway 
em: em 
turkish: turkish 
xam: xam 
pri: pri 
remastered: remastered 
session: session 
fft: fft 
sayin: sayin 
iq: iq 
ml: ml 
mcphillip: mcphillip 
nailogical: nailogical 
also: also 
vietnamese: vietnamese 
galactic: galactic 
umaczenia: umaczenia 
became: became 
polski: polski 
translation: translations translation 
traducci: traducci 
marlon: marlon 
lotto: lotto 
nahmir: nahmir 
china: china 
smell: smell 
sensei: sensei 
final: final 
ng: ng 
vuitton: vuitton 
bersetzung: bersetzung 
white: white 
lit: lit 
deji: deji 
nusky: nusky 
end: end 
fact: facts 
ram: ram 
lethal: lethal 
interlude: interlude 
oof: oof 
tutoring: tutoring 
imbraydn: imbraydn 
sinner: sinner 
meth: meth 
system: system 
eastmix: eastmix 
gucci: gucci 
youtube: youtube 
chicken: chicken 
chris: chris 
cancel: cancel 
meek: meek 
trap: trap 
z: z 
high: high 
ayeyahzee: ayeyahzee 
brenden: brenden 
record: record records 
reloaded: reloaded 
med: meds 
airline: airline 
whitney: whitney 
nog: nog 
lukach: lukach 
mastering: mastering 
way: way 
new: new 
look: look 
abortion: abortion 
highly: highly 
let: lets 
montana: montana 
da: da 
pete: pete 
ovo: ovo 
mix: mix 
term: terms 
east: east 
polskie: polskie 
rent: rent 
take: take 
original: original 
magma: magma 
lord: lord 
interpolate: interpolate 
whopper: whopper 
chain: chain 
god: god 
vi: vi 
halla: halla 
cosita: cosita 
la: la 
braggadocious: braggadocious 
estonian: estonian 
dfill: dfill 
embed: embed 
vald: vald 
first: first 
luckhaos: luckhaos 
youngest: youngest 
ft: ft 
grandayy: grandayy 
globglogabgalab: globglogabgalab 
ever: ever 
lge: lge 
galaxy: galaxy 
fame: fame 
hunnid: hunnid 
duplex: duplex 
hot: hot 
radio: radio 
lyon: lyons 
rotorial: rotorial 
middle: middle 
tiger: tiger 
biya: biya 
indian: indian 
nike: nike 
bos: boss 
ultimate: ultimate 
like: like 
distinguish: distinguish 
tantris: tantris 
glend: glend 
westside: westside 
antysmogowa: antysmogowa 
fuc: fuc 
shadow: shadow 
fuck: fuck 
huh: huh 
hayden: hayden 
dababy: dababy 
pod: pod 
wrist: wrist 
forgot: forgot 
slide: slide 
source: source 
fiz: fiz 
sign: sign 
flyingkitty: flyingkitty 
q: q 
ganni: ganni 
murray: murray 
pop: pop 
htgaming: htgaming 
r: r 
minute: minutes 
bitcoin: bitcoin 
spanish: spanish 
smith: smith 
country: country 
cody: cody 
fais: fais 
dia: dia 
llc: llc 
nojuice: nojuice 
sublime: sublime 
official: official 
hack: hack 
tape: tape 
jswizz: jswizz 
insight: insight 
e: e 
expand: expand 
big: big 
sippin: sippin 
recording: recording 
qui: qui 
feel: feel 
failed: failed 
episode: episode 
mac: mac 
phantom: phantom 
entb: entb 
dave: dave 
mumble: mumble 
los: los 
repeating: repeating 
themysticaldrawings: themysticaldrawings 
bhabie: bhabie 
derek: derek 
caution: caution 
track: track 
til: til 
priinny: priinny 
love: love 
crypt: crypt 
disstrack: disstrack 
meme: meme 
publishing: publishing 
lory: lory 
aj: aj 
sam: sam 
quiere: quiere 
willis: willis 
date: date 
cory: cory 
food: food 
cbmix: cbmix 
uzzn: uzzn 
c: c 
moim: moim 
ver: ver 
megamix: megamix 
fast: fast 
example: examples 
flyin: flyin 
kicked: kicked 
keese: keese 
pumpovich: pumpovich 
jhova: jhova 
ak: ak 
march: march 
squadeca: squadeca 
daniel: daniel 
sorry: sorry 
mashup: mashup 
bedoes: bedoes 
tide: tide 
ua: ua 
h: h 
individual: individual 
easyrap: easyrap 
jewerly: jewerly 
tha: tha 
ab: abs 
hodl: hodl 
single: single 
shoot: shoot 
hen: hen 
smoke: smoke 
bell: bell 
wynne: wynne 
everybody: everybody 
jovens: jovens 
billy: billy 
aaron: aaron 
know: know 
fra: fra 
louie: louie 
personal: personal 
gator: gator 
nyanners: nyanners 
transcription: transcription 
eminem: eminem 
might: might 
katowice: katowice 
craft: craft 
gone: gone 
slangin: slangin 
yeah: yeah 
gullit: gullit 
dope: dope 
pezet: pezet 
pick: pick 
toasty: toasty 
dis: diss 
breath: breath 
balvin: balvin 
warner: warner 
ghtone: ghtone 
vydia: vydia 
music: music 
l: l 
door: door 
hotspanish: hotspanish 
teacher: teacher 
global: global 
divine: divine 
carri: carri 
live: live 
mart: mart 
kid: kid 
br: br 
alsina: alsina 
ghost: ghost 
bottom: bottoms 
gnealz: gnealz 
question: question 
killa: killa 
dex: dex 
maska: maska 
drop: drop 
octobersfullmoon: octobersfullmoon 
shop: shop 
espa: espa 
produced: produced 
learn: learn 
texture: texture 
remy: remy 
ian: ian 
flexer: flexer 
king: king 
flex: flex 
fnatic: fnatic 
ring: ring 
marshez: marshez 
flame: flame 
verse: verse 
mcluvin: mcluvin 
young: young 
suikon: suikon 
maniac: maniac 
yunus: yunus 
bighead: bighead 
topic: topics 
royce: royce 
marchiafava: marchiafava 
talha: talha 
gun: guns 
administration: administration 
scholar: scholars 
drake: drake 
fire: fire 
madeintyo: madeintyo 
franciscoxx: franciscoxx 
viva: viva 
fuckin: fuckin 
toku: toku 
par: par 
quadeca: quadeca 
backwards: backwards 
version: version 
dissing: dissing 
rd: rd 
jova: jova 
audio: audio 
fazejemoeder: fazejemoeder 
beat: beat 
maes: maes 
