talk: talk talks 
per: per 
italic: italics 
constantly: constantly 
brilliance: brilliance 
model: model 
around: around 
chorus: chorus 
tell: tells 
still: still 
burn: burn 
section: section 
reynolds: reynolds 
syllable: syllables 
unafraid: unafraid 
drum: drum drums 
theater: theater 
macatangay: macatangay 
pointing: pointing 
cabinet: cabinet 
collection: collection 
use: use 
fallon: fallon 
lyric: lyrics lyric 
give: give 
casal: casal 
stop: stop 
guitar: guitar 
put: put 
information: information 
duel: duel 
rochambeau: rochambeau 
boy: boy 
breathe: breathe 
particularly: particularly 
daveed: daveed 
w: w 
world: world 
holding: holdings 
election: election 
yorktown: yorktown 
helpless: helpless 
oh: oh 
frenchman: frenchman 
v: v 
ha: ha 
gift: gifts 
back: back 
mouth: mouth 
wanna: wanna 
jackson: jackson 
much: much 
alex: alex 
kurt: kurt 
privacy: privacy 
artist: artists 
army: army 
adam: adams 
manage: manage 
loved: loved 
go: go 
answer: answer 
upside: upside 
share: share 
second: second 
never: never 
quiet: quiet 
anyone: anyone 
k: k 
join: join 
tim: tim 
cappella: cappella 
andres: andres 
guideline: guidelines 
check: check 
song: song songs 
credit: credits 
assumed: assumed 
man: man 
gonna: gonna 
appearance: appearance 
even: even 
uestlove: uestlove 
uptown: uptown 
instrumental: instrumental 
battle: battle 
sherman: sherman 
winter: winter 
fluent: fluent 
mixer: mixer 
liar: liar 
emerge: emerge 
le: less 
comment: comment comments 
mental: mental 
conductor: conductor 
patter: patter 
contributor: contributor contributors 
actually: actually 
read: read 
avatar: avatar 
erin: erin 
part: parts part 
resilience: resilience 
lafayette: lafayette 
header: headers 
right: right rights 
next: next 
cast: cast 
ask: ask 
written: written 
performance: performance 
format: format 
vocalist: vocalists 
ball: ball 
ah: ah 
american: american 
developer: developers 
non: non 
cohen: cohen 
pecf: pecf 
diggs: diggs 
refuted: refuted 
theodosia: theodosia 
america: america 
september: september 
alive: alive 
isaiah: isaiah 
side: side 
eventually: eventually 
view: view 
musical: musical musicals 
france: france 
penzance: penzance 
visit: visit 
escapin: escapin 
created: created 
p: p 
uh: uh 
breakneck: breakneck 
waving: waving 
burr: burr 
alexander: alexander 
faster: faster 
broken: broken 
different: different 
washington: washington 
bill: bill 
shot: shot 
fight: fight 
vida: vida 
reprise: reprise 
hour: hours 
enough: enough 
granted: granted 
video: videos 
featured: featured 
surrender: surrender 
light: light 
tag: tags 
word: words 
chime: chimes 
pretty: pretty 
soldier: soldiers 
schuyler: schuyler 
character: character 
married: married 
today: today 
keyboard: keyboards 
known: known 
pacing: pacing 
ascap: ascap 
al: al 
redcoat: redcoats 
hamilton: hamilton 
takin: takin 
hammond: hammond 
type: type 
release: release 
b: b 
defeat: defeat 
pirate: pirates 
fit: fit fits 
group: group 
odom: odom 
getting: getting 
step: step 
would: would 
together: together 
french: french 
polka: polka 
horse: horse 
x: x 
one: one ones 
transcriber: transcribers 
honor: honor 
balance: balance 
away: away 
fund: funds 
according: according 
com: com 
challenge: challenge 
mario: mario 
randy: randy 
yankovic: yankovic 
rafael: rafael 
policy: policy 
publisher: publisher 
bench: bench 
ten: ten 
etc: etc 
sell: sell 
british: british 
ingenuitive: ingenuitive 
span: span 
sister: sisters 
annotation: annotation 
sondheim: sondheim 
company: company 
life: lives 
along: along 
best: best 
viola: viola 
richard: richard 
consolidate: consolidate 
wood: wood 
genius: genius 
manuel: manuel 
scott: scott 
somehow: somehow 
sample: samples sample 
press: press 
battlefield: battlefield 
cut: cut 
hurricane: hurricane 
rap: rap 
farmer: farmer 
revolution: revolution 
pt: pt 
wide: wide 
title: title 
bloodstain: bloodstains 
programmer: programmer 
major: major 
banjo: banjo 
puzzle: puzzle 
else: else 
u: u us 
verified: verified 
succeed: succeed 
n: n 
singer: singer 
g: g 
letter: letter 
primary: primary 
show: show 
room: room 
knowledge: knowledge 
seven: seven 
reiner: reiner 
jr: jr 
shower: shower 
make: make 
weapon: weapon 
immigrant: immigrant 
death: death 
line: lines 
higher: higher 
weird: weird 
licensing: licensing 
j: j 
coyne: coyne 
yo: yo 
obedient: obedient 
fighting: fighting 
someone: someone 
soundtrack: soundtrack 
cello: cello 
accent: accent 
turned: turned 
say: say 
ol: ol 
field: field 
forum: forum 
tonight: tonight 
traducciones: traducciones 
woman: women 
inside: inside 
percussion: percussion 
advertise: advertise 
meet: meet 
watch: watch 
jumping: jumping 
add: add 
understand: understand 
tactical: tactical 
robin: robin 
guide: guide 
history: history 
lin: lin 
basic: basics 
quagmire: quagmire 
break: break breaks 
hold: holds hold 
promote: promote 
possibly: possibly 
job: jobs 
copyright: copyright 
biggest: biggest 
cadence: cadences 
confusin: confusin 
bold: bold 
dear: dear 
certain: certain 
f: f 
provide: provide 
toss: toss 
pamphlet: pamphlet 
chappell: chappell 
contact: contact 
turn: turns turn 
wife: wives 
em: em 
collaborator: collaborator 
victorious: victorious 
ml: ml 
harp: harp 
rapping: rapping 
production: production 
also: also 
engagin: engagin 
get: get 
yield: yield 
mean: mean 
distinction: distinction 
eye: eyes 
translation: translations 
traducci: traducci 
know: knows know 
conventional: conventional 
white: white 
orchestration: orchestration 
remains: remains 
argues: argues 
fastest: fastest 
anja: anja 
fact: facts 
end: end 
interlude: interlude 
latham: latham 
synthesizer: synthesizer 
cancel: cancel 
trench: trench 
range: range 
z: z 
come: come comes 
way: way 
new: new 
sir: sir 
crowley: crowley 
secret: secret 
pulse: pulse 
satisfied: satisfied 
piece: pieces 
term: terms 
mania: mania 
flag: flag 
thought: thought 
take: take 
black: black 
modern: modern 
original: original 
interpolate: interpolate 
whopper: whopper 
general: general 
betsy: betsy 
keep: keep 
la: la 
ensemble: ensemble 
barrel: barrels 
defeated: defeated 
blow: blow 
gotoh: gotoh 
embed: embed 
whole: whole 
men: men 
first: first 
tom: tom 
forero: forero 
ft: ft 
time: time 
last: last 
shift: shifts 
wait: wait 
superpower: superpower 
hot: hot 
ultimate: ultimate 
commandment: commandments 
hysterical: hysterical 
like: like 
distinguish: distinguish 
makin: makin 
better: better 
contains: contains 
volunteer: volunteer 
source: source 
leave: leave 
need: need 
miranda: miranda 
hand: hand 
sign: sign 
q: q 
sooner: sooner 
sea: sea 
stay: stay 
r: r 
favorite: favorite 
enragin: enragin 
minute: minutes 
bass: bass 
llc: llc 
jimmy: jimmy 
ross: ross 
servant: servant 
rein: reins 
insight: insight 
ya: ya 
studio: studios 
e: e 
expand: expand 
confoundin: confoundin 
lacamoire: lacamoire 
recording: recording 
ryone: ryone 
great: great 
christopher: christopher 
johnson: johnson 
may: may 
repeating: repeating 
sound: sounds 
track: track 
ev: ev 
rendezvous: rendezvous 
sung: sung 
love: love 
easier: easier 
date: date 
benim: benim 
girl: girls 
c: c 
fast: fast 
paced: paced 
tide: tide 
interview: interview 
h: h 
individual: individual 
land: land 
pace: pace 
single: single 
early: early 
aaron: aaron 
ship: ships 
personal: personal 
transcription: transcription 
benny: benny 
chart: charts 
might: might 
match: matches 
libresco: libresco 
dy: dies 
henchman: henchmen 
happens: happens 
moment: moment 
waiting: waiting 
practical: practical 
warner: warner 
vocal: vocals 
music: music 
miss: miss 
fivethirtyeight: fivethirtyeight 
l: l 
global: global 
broadway: broadway 
question: question 
war: war 
troop: troops 
masterer: masterer 
drop: drop 
gotta: gotta 
redder: redder 
shop: shop 
espa: espa 
produced: produced 
learn: learn 
violin: violin 
point: points 
draft: draft 
verse: verse 
laura: laura 
recorded: recorded 
scatter: scatter 
gun: guns 
ragtag: ragtag 
administration: administration 
wasserman: wasserman 
scholar: scholars 
viva: viva 
story: story 
interpolation: interpolations 
floss: floss 
leslie: leslie 
