koen: koen 
ruby: ruby 
nightmare: nightmares 
treeshas: treeshas 
tradu: tradu 
italic: italics 
karma: karma 
chorus: chorus 
still: still 
section: section 
nederlandse: nederlandse 
nobody: nobody 
ye: ye 
kevin: kevin 
sadfem: sadfem 
deutsch: deutsch 
nauseous: nauseous 
remixes: remixes 
carry: carry 
debut: debut 
iamcavin: iamcavin 
kyle: kyle 
traductions: traductions 
trogan: trogan 
collection: collection 
pmp: pmp 
wmashup: wmashup 
randall: randall 
use: use 
lyric: lyrics lyric 
bad: bad 
gmc: gmc 
meia: meia 
outro: outro 
alleged: alleged 
information: information 
hanahata: hanahata 
achievement: achievements 
w: w 
uzi: uzi 
world: world 
holding: holdings 
scar: scars 
de: de 
traduction: traduction 
oh: oh 
v: v 
driver: drivers 
platform: platform 
baby: baby 
pxstol: pxstol 
unveiled: unveiled 
vertaling: vertaling 
drug: drugs 
moneyken: moneyken 
rkthim: rkthim 
privacy: privacy 
artist: artists artist 
ayy: ayy 
carter: carter 
loved: loved 
go: go goes 
alright: alright 
bro: bro 
another: another 
juice: juice 
apply: apply 
ubem: ubem 
dick: dick 
eviri: eviri 
answer: answer 
soundcloud: soundcloud 
share: share 
roll: roll 
second: second 
recently: recently 
k: k 
guideline: guidelines 
check: check 
song: song songs 
credit: credits 
mediocre: mediocre 
tenebrous: tenebrous 
dexter: dexter 
deutsche: deutsche 
wayne: wayne 
cray: cray 
feature: features feature 
even: even 
engineer: engineer 
bae: bae 
titled: titled 
lottery: lottery 
leite: leite 
roblox: roblox 
texted: texted 
ii: ii 
comment: comment comments 
contributor: contributor contributors 
actually: actually 
read: read 
lil: lil 
side: sides 
savage: savage 
laydon: laydon 
part: parts part 
header: headers 
right: right rights 
pashto: pashto 
ask: ask 
written: written 
performance: performance 
format: format 
vocalist: vocalists 
uploaded: uploaded 
developer: developers 
fly: fly 
riot: riots 
emo: emo 
dente: dente 
remix: remix 
arc: arc 
wrld: wrld 
rk: rk 
mixing: mixing 
electric: electric 
view: view 
musical: musical 
dead: dead 
visit: visit 
gunfire: gunfire 
created: created 
studio: studio 
richh: richh 
head: head 
xxxtentacion: xxxtentacion 
p: p 
ooh: ooh 
uh: uh 
snippet: snippet 
broken: broken 
different: different 
nandinho: nandinho 
vida: vida 
arabic: arabic 
e: es e 
video: videos 
sxuuly: sxuuly 
abdulleh: abdulleh 
featured: featured 
album: album 
taylor: taylor 
vibe: vibes 
tag: tags 
label: label 
mc: mc 
matter: matter 
hacked: hacked 
ascap: ascap 
al: al 
explanation: explanation 
type: type 
release: release 
b: b 
knight: knight 
group: group 
caz: caz 
trippie: trippie 
bmi: bmi 
together: together 
intro: intro 
switchin: switchin 
stream: streams 
french: french 
x: x 
transcriber: transcribers 
night: night 
away: away 
course: course 
skrow: skrow 
received: received 
track: tracks track 
peace: peace 
policy: policy 
publisher: publisher 
ayala: ayala 
zuiy: zuiy 
raised: raised 
alternative: alternative 
etc: etc 
sell: sell 
fran: fran 
took: took 
portugu: portugu 
summer: summer 
luv: luv 
siyahxo: siyahxo 
annotation: annotation 
obsession: obsession 
broke: broke 
purpp: purpp 
instagram: instagram 
polish: polish 
posted: posted 
canton: canton 
later: later 
genius: genius 
nick: nick 
scott: scott 
amra: amra 
lost: lost 
sample: samples sample 
featuring: featuring 
anymore: anymore 
press: press 
frick: frick 
russian: russian 
rap: rap 
misconception: misconceptions 
pt: pt 
bersetzungen: bersetzungen 
xero: xero 
taz: taz 
forever: forever 
u: u us 
verified: verified 
n: n 
g: g 
yunglian: yunglian 
ohio: ohio 
knowledge: knowledge 
dummo: dummo 
yessirskiii: yessirskiii 
soose: soose 
death: death 
line: lines 
brasil: brasil 
licensing: licensing 
j: j 
german: german 
sony: sony 
throw: throw 
life: life 
heldens: heldens 
th: th 
someone: someone 
lilberryblunt: lilberryblunt 
sent: sent 
glove: glove 
italiane: italiane 
nederland: nederlands 
reside: reside 
vertalingen: vertalingen 
ol: ol 
orlando: orlando 
forum: forum 
albedo: albedo 
pet: pet 
traducciones: traducciones 
rodrigo: rodrigo 
said: said 
inside: inside 
advertise: advertise 
dealing: dealing 
ai: aises ais 
add: add 
dyin: dyin 
thots: thots 
gaining: gaining 
license: license 
august: august 
produce: produce 
fact: fact facts 
understand: understand 
florida: florida 
guide: guide 
swear: swear 
traduzione: traduzione 
montreality: montreality 
please: please 
ab: ab 
promote: promote 
hip: hip 
save: save 
bonus: bonus 
chaunay: chaunay 
albanian: albanian 
kobalt: kobalt 
gio: gio 
labrae: labrae 
job: jobs 
biggest: biggest 
copyright: copyright 
bold: bold 
f: f 
umaczenie: umaczenie 
contact: contact 
em: em 
turkish: turkish 
jocelyn: jocelyn 
ml: ml 
brought: brought 
mira: mira 
mine: mine 
jonxgb: jonxgb 
also: also 
adviser: adviser 
eye: eyes 
umaczenia: umaczenia 
polski: polski 
brynn: brynn 
translation: translations translation 
traducci: traducci 
friend: friend 
close: close 
boi: boi 
bersetzung: bersetzung 
wit: wit 
dutch: dutch 
interlude: interlude 
chris: chris 
beefing: beefing 
cancel: cancel 
trap: trap 
z: z 
tweeted: tweeted 
record: record 
surroundings: surroundings 
olivia: olivia 
depression: depression 
made: made 
nibba: nibba 
polaris: polaris 
term: terms 
polskie: polskie 
empire: empire 
interpolate: interpolate 
latinautor: latinautor 
god: god 
hop: hop 
vert: vert 
la: la 
aise: aise 
embed: embed 
kmr: kmr 
first: first 
retro: retro 
detail: detail 
universal: universal 
ft: ft 
time: time 
collaborated: collaborated 
hot: hot 
drg: drg 
ultimate: ultimate 
bts: bts 
like: like 
cried: cried 
distinguish: distinguish 
million: million 
cover: covers 
jenn: jenn 
cmrra: cmrra 
mata: mata 
removed: removed 
fuck: fuck 
huh: huh 
source: source 
need: need 
sign: sign 
play: plays 
redliquid: redliquid 
q: q 
unknown: unknown 
day: day 
pop: pop 
r: r 
revenge: revenge 
pp: pp 
redd: redd 
spanish: spanish 
llightskinned: llightskinned 
llc: llc 
royalty: royalties 
insight: insight 
usa: usa 
hapis: hapis 
expand: expand 
shqip: shqip 
recording: recording 
feel: feel 
portuguese: portuguese 
held: held 
repeating: repeating 
dark: dark 
sylvan: sylvan 
love: love 
find: find 
pole: poles 
publishing: publishing 
date: date 
girl: girls 
calv: calv 
c: c 
thierry: thierry 
putting: putting 
grandy: grandy 
flores: flores 
h: h 
individual: individual 
tae: tae 
scsp: scsp 
certification: certifications 
cause: cause 
publicity: publicity 
everybody: everybody 
know: know 
emxnvel: emxnvel 
heart: heart 
personal: personal 
transcription: transcription 
chart: charts 
might: might 
pre: pre 
dy: dies 
heaven: heaven 
yeah: yeah 
owee: owee 
pick: pick 
dis: diss 
italian: italian 
music: music 
l: l 
needed: needed 
listras: listras 
missi: missi 
kid: kid 
travis: travis 
question: question 
drop: drop 
shop: shop 
espa: espa 
produced: produced 
learn: learn 
ecstasy: ecstasy 
scammer: scammers 
verse: verse 
happened: happened 
gunfyre: gunfyre 
young: young 
recorded: recorded 
fantasy: fantasy 
italiana: italiana 
ck: ck 
scholar: scholars 
lacue: lacue 
hub: hub 
ripped: ripped 
viva: viva 
as: ass 
version: version 
nikito: nikito 
traduzioni: traduzioni 
entertainment: entertainment 
beat: beat 
italiano: italiano 
