equality: equality 
stereotype: stereotypes 
damn: damn 
fear: fear fears 
hallway: hallway 
important: important 
italic: italics 
chorus: chorus 
still: still 
section: section 
represents: represents 
mary: mary 
success: success 
february: february 
anointed: anointed 
hate: hate hates 
good: good 
certificate: certificate 
patient: patient 
remixes: remixes 
debut: debut 
little: little 
andrew: andrew 
ignores: ignores 
traductions: traductions 
collection: collection 
angel: angel 
use: use 
lyric: lyrics lyric 
outro: outro 
starting: starting 
information: information 
tear: tears 
boy: boy 
kid: kids 
social: social 
w: w 
walk: walk 
world: world 
couple: couples 
concert: concert 
making: making 
holding: holdings 
underneath: underneath 
line: line lines 
traduction: traduction 
oh: oh 
marriage: marriages marriage 
sunday: sundays 
v: v 
cowboy: cowboy 
daily: daily 
kramer: kramer 
third: third 
pigment: pigment 
wa: wa 
order: order 
back: back 
lesser: lesser 
wake: wake 
veil: veil 
privacy: privacy 
artist: artists 
writing: writing 
loved: loved 
go: go 
bizzle: bizzle 
child: children 
bombom: bombom 
rm: rm 
color: color 
answer: answer 
jon: jon 
share: share 
animal: animal 
uncle: uncle uncles 
dropped: dropped 
message: message 
k: k 
whatever: whatever 
think: think 
co: co 
guideline: guidelines 
gay: gay 
check: check 
song: song songs 
credit: credits 
love: loves love 
november: november 
man: man 
gonna: gonna 
even: even 
lap: lap 
engineer: engineer 
extended: extended 
liar: liar 
thousand: thousand 
money: money 
cathedral: cathedral 
law: law laws 
comment: comment comments 
commentary: commentary 
example: example 
book: book 
mom: mom 
contributor: contributor contributors 
read: read 
word: word words 
lil: lil 
oppression: oppression 
part: parts part 
header: headers 
right: right rights 
ask: ask 
written: written 
cast: cast 
key: keys 
format: format 
haze: haze 
vocalist: vocalists 
strip: strip 
service: service 
hiphoped: hiphoped 
developer: developers 
preach: preach 
july: july 
america: america 
scholar: scholar scholars 
die: die 
mixing: mixing 
writes: writes 
view: view 
powerful: powerful 
become: become 
style: style 
musical: musical 
visit: visit 
covid: covid 
created: created 
billboard: billboard 
studio: studio studios 
ryanlewis: ryanlewis 
head: head 
p: p 
play: play 
see: see 
human: humans human 
meant: meant 
call: call 
broken: broken 
united: united 
different: different 
washington: washington 
remember: remember 
rawlings: rawlings 
fight: fight 
led: led 
twelve: twelve 
vida: vida 
hour: hours 
yet: yet 
video: videos 
featured: featured 
album: album 
tag: tags 
get: gets 
hall: hall 
issue: issue 
water: water 
victory: victory 
got: got 
explicitly: explicitly 
poisoned: poisoned 
culture: culture 
type: type 
joslyn: joslyn 
release: release 
b: b 
in: ins 
disturbed: disturbed 
starter: starters 
boot: boots 
equal: equal 
playing: playing 
would: would 
intro: intro 
french: french 
notable: notable 
popular: popular 
one: one 
x: x 
transcriber: transcribers 
away: away 
thirty: thirty 
round: round 
macklemore: macklemore 
policy: policy 
raised: raised 
ten: ten 
sawayama: sawayama 
etc: etc 
sell: sell 
could: could 
fran: fran 
greg: greg 
wall: walls 
rewiring: rewiring 
historical: historical 
annotation: annotation 
support: support 
warm: warm 
point: point 
ben: ben 
religion: religion 
told: told 
bunch: bunch 
conservative: conservatives 
genius: genius 
somehow: somehow 
people: people 
featuring: featuring 
sample: samples sample 
press: press 
five: five 
freestyle: freestyle 
federal: federal 
rap: rap 
stolen: stolen 
genre: genre 
year: years 
faggot: faggots 
sound: sound 
pt: pt 
walking: walking 
else: else 
voiceless: voiceless 
u: u us 
start: start 
believe: believe 
hh: hh 
supreme: supreme 
verified: verified 
n: n 
caused: caused 
number: number 
g: g 
understandable: understandable 
face: face 
primary: primary 
paper: paper 
room: room 
knowledge: knowledge 
legalizing: legalizing 
make: make 
audience: audiences 
brave: brave 
finally: finally 
death: death 
voted: voted 
gold: gold 
licensing: licensing 
j: j 
th: th 
fighting: fighting 
freedom: freedom 
soundtrack: soundtrack 
cello: cello 
pool: pool 
decision: decision 
taught: taught 
change: change 
significance: significance 
aw: aw 
forum: forum 
ryan: ryan 
coincidental: coincidental 
said: said 
difference: difference 
advertise: advertise 
ai: aises ais 
add: add 
war: wars 
prohibiting: prohibiting 
understand: understand 
recognition: recognition 
danthology: danthology 
rather: rather 
guide: guide 
josh: josh 
treatment: treatment 
founded: founded 
promote: promote 
hip: hip 
defend: defend 
job: jobs 
hundred: hundred 
mainstream: mainstream 
biggest: biggest 
forgotten: forgotten 
copyright: copyright 
bold: bold 
numb: numb 
f: f 
everyone: everyone 
complexion: complexion 
cover: cover covers 
board: board 
invalidated: invalidated 
rushing: rushing 
contact: contact 
em: em 
state: state states 
sayin: sayin 
yaminobahamut: yaminobahamut 
ml: ml 
trippin: trippin 
acceptance: acceptance 
also: also 
eye: eyes 
became: became 
played: played 
translation: translations translation 
sex: sex 
church: church 
white: white 
pause: pause 
fact: facts 
interlude: interlude 
keep: keeps 
characteristic: characteristics 
lately: lately 
youtube: youtube 
racist: racist 
cancel: cancel 
conceived: conceived 
plagued: plagued 
z: z 
holy: holy 
hateful: hateful 
come: come 
ago: ago 
turn: turn 
mastering: mastering 
referendum: referendum 
made: made 
nah: nah 
top: top 
out: outs 
ali: ali 
term: terms 
disposition: disposition 
thought: thought 
paraphrase: paraphrase 
politics: politics 
indie: indie 
interpolate: interpolate 
whopper: whopper 
god: god 
froukje: froukje 
sit: sit 
hop: hop 
la: la 
response: response 
comfortable: comfortable 
aise: aise 
embed: embed 
first: first 
grade: grade 
tried: tried 
ft: ft 
court: court 
time: time 
last: last 
progress: progress 
hot: hot 
castle: castle 
heist: heist 
since: since 
ultimate: ultimate 
thin: thin 
pee: pee 
wing: wing 
like: like 
distinguish: distinguish 
solve: solve 
amil: amil 
two: two 
piano: piano 
seattle: seattle 
gender: gender 
remaining: remaining 
source: source 
sign: sign 
trombone: trombone 
q: q 
soak: soak 
day: day 
pop: pop 
amilcook: amilcook 
favor: favor 
r: r 
place: place 
rina: rina 
rucka: rucka 
llc: llc 
jimmy: jimmy 
legalize: legalize 
insight: insight 
murs: murs 
e: e 
expand: expand 
cry: crying 
big: big 
league: league 
recording: recording 
pain: pain 
april: april 
great: great 
repeating: repeating 
rooted: rooted 
iovine: iovine 
track: track 
although: although 
vote: vote 
til: til 
hit: hit 
hold: hold 
kodaline: kodaline 
legalized: legalized 
behind: behind 
natalie: natalie 
thrift: thrift 
speech: speeches 
sterling: sterling 
entirety: entirety 
date: date 
girl: girls 
yrjzbe: yrjzbe 
c: c 
skin: skin 
draw: draw 
march: march 
straight: straight 
homophobic: homophobic 
math: math 
daniel: daniel 
mashup: mashup 
synonymous: synonymous 
h: h 
individual: individual 
shift: shift 
cause: cause 
single: single 
promotes: promotes 
everybody: everybody 
know: know 
heart: heart 
personal: personal 
transcription: transcription 
chart: charts 
might: might 
pre: pre 
idea: idea 
yeah: yeah 
http: https 
inspiration: inspiration 
kim: kim 
glee: glee 
lewis: lewis 
music: music 
l: l 
attributed: attributed 
live: live 
kept: kept 
question: question 
something: something 
neon: neon 
drop: drop 
shop: shop 
lgbtq: lgbtq 
produced: produced 
learn: learn 
violin: violin 
cured: cured 
wanted: wanted 
verse: verse 
tv: tv 
homosexuality: homosexuality 
recorded: recorded 
kind: kind 
cook: cook 
viva: viva 
guess: guess 
educator: educator 
lambert: lambert 
