photographer: photographer 
fear: fear 
gleamin: gleamin 
xdreambae: xdreambae 
tradu: tradu 
bored: bored 
famous: famous 
italic: italics 
bitch: bitch bitches 
loo: loo 
morawski: morawski 
mastered: mastered 
chorus: chorus 
marketing: marketing 
still: still 
burn: burn 
section: section 
hanes: hanes 
loop: loop 
act: act 
nederlandse: nederlandse 
let: let 
ant: ant 
international: international 
stealing: stealing 
lash: lashes 
deutsch: deutsch 
remixes: remixes 
beamin: beamin 
elise: elise 
sb: sb 
courtney: courtney 
reference: reference 
traductions: traductions 
collection: collection 
neck: neck 
focus: focus 
interpolates: interpolates 
roadtrip: roadtrip 
use: use 
woman: woman 
samantha: samantha 
boasting: boasting 
heard: heard 
hammerstein: hammerstein 
corp: corp 
lyric: lyrics lyric 
bad: bad 
andrew: andrews 
needymoon: needymoon 
jayniac: jayniac 
stop: stop 
tayla: tayla 
grammy: grammy 
put: put 
vito: vito 
information: information 
jarvis: jarvis 
including: including 
wellz: wellz 
position: positions 
kenneth: kenneth 
kid: kids 
social: social 
personnel: personnel 
six: six 
world: world 
holding: holdings 
w: w 
hickey: hickey 
making: making 
traduction: traduction 
oh: oh 
v: v 
baby: baby 
tied: tied 
gonzaga: gonzaga 
sneak: sneak 
vertaling: vertaling 
back: back 
york: york 
alex: alex 
peek: peek 
kurt: kurt 
fortnite: fortnite 
concord: concord 
azzy: azzy 
artist: artists 
want: want wants 
lecrae: lecrae 
privacy: privacy 
write: write 
nasa: nasa 
blaccmass: blaccmass 
njomza: njomza 
writing: writing 
donna: donna 
augustus: augustus 
uma: uma 
loved: loved 
go: go 
olee: olee 
rodgers: rodgers 
budget: budget 
buy: buy 
si: si 
ca: ca 
brazil: brazil 
juice: juice 
brendan: brendan 
run: run 
kaydence: kaydence 
kidz: kidz 
earworm: earworm 
eviri: eviri 
answer: answer 
share: share shares 
hryeyshyn: hryeyshyn 
lux: lux 
pay: pay 
feminine: feminine 
animal: animal 
bloodline: bloodline 
second: second 
never: never 
except: except 
playtime: playtime 
k: k 
tim: tim 
quinn: quinn 
think: think 
guideline: guidelines 
promotional: promotional 
check: check checks 
song: song songs 
credit: credits credit 
eddie: eddie 
hebrew: hebrew 
deutsche: deutsche 
associated: associated 
republic: republic 
called: called 
feature: features feature 
mashups: mashups 
even: even 
engineer: engineer 
dancing: dancing 
instrumental: instrumental 
bodyguard: bodyguard 
ecklund: ecklund 
controversy: controversies 
rift: rift 
sica: sica 
money: money 
sp: sp 
merrell: merrell 
ii: ii 
comment: comment comments 
tour: tour 
wrote: wrote 
romanian: romanian 
verse: verses verse 
contributor: contributor contributors 
district: district 
read: read 
lil: lil 
savage: savage 
call: calls 
part: parts part 
background: background 
next: next 
header: headers 
documentary: documentary 
ask: ask 
written: written 
performance: performance performances 
format: format 
sierra: sierra 
vocalist: vocalists 
uploaded: uploaded 
scene: scenes 
developer: developers 
christmas: christmas 
bridge: bridge 
problem: problems 
inutilismo: inutilismo 
rom: rom 
decide: decide 
twin: twins 
braun: braun 
bmg: bmg 
friendship: friendship 
john: john 
phonographic: phonographic 
director: director 
remix: remix 
magazine: magazine 
wrld: wrld 
rk: rk 
mixing: mixing 
ox: ox 
view: view 
musical: musical 
visit: visit 
searching: searching 
kaye: kaye 
created: created 
billboard: billboard 
shit: shit 
studio: studio studios 
head: head 
youpunk: youpunk 
p: p 
see: see 
schneider: schneider 
snippet: snippet 
conjunto: conjunto 
oscar: oscar 
toca: toca 
wearing: wearing 
closest: closest 
retail: retail 
medium: media 
alexander: alexander 
broken: broken 
different: different 
legal: legal 
shine: shine 
united: united 
bought: bought 
bright: bright 
tone: tone 
rock: rock 
red: red 
ring: rings ring 
enough: enough 
charlie: charlie 
video: videos video 
machine: machines 
story: stories 
gangsta: gangstas 
e: es e 
featured: featured 
album: album 
taylor: taylor 
tag: tags 
grant: grants 
label: label 
mc: mc 
parody: parody 
brag: brag 
ghenea: ghenea 
mr: mrs mr 
michael: michael 
ascap: ascap 
al: al 
subscriber: subscribers 
luvi: luvi 
got: got 
icona: icona 
matching: matching 
type: type 
release: release 
b: b 
grandarimusic: grandarimusic 
instasamka: instasamka 
announced: announced 
rack: racks 
pluffaduff: pluffaduff 
right: rights 
lace: lace 
atm: atm 
group: group 
getting: getting 
playing: playing 
williamson: williamson 
traducere: traducere 
jackie: jackie 
han: hans 
bmi: bmi 
french: french 
inc: inc 
representation: representation 
gloss: gloss 
x: x 
one: one 
breakfast: breakfast 
transcriber: transcribers 
night: night 
house: houses house 
away: away 
prior: prior 
adrianna: adrianna 
blu: blu 
randy: randy 
via: via 
policy: policy 
publisher: publisher 
bigg: bigg 
future: future 
tamerlane: tamerlane 
etc: etc 
sell: sell 
friend: friends 
erban: erban 
fran: fran 
portugu: portugu 
minute: minute 
needy: needy 
wendy: wendy 
molotov: molotov 
number: numbers number 
summer: summer 
annotation: annotation 
perform: perform 
over: overs 
company: company 
mcdaniels: mcdaniels 
instagram: instagram 
polish: polish 
best: best 
trouble: trouble 
ghostin: ghostin 
imagem: imagem 
luxury: luxuries 
posted: posted 
richard: richard 
ttelse: ttelse 
diamond: diamonds 
later: later 
thank: thank 
genius: genius 
scott: scott 
tsui: tsui 
tank: tanks 
skon: skon 
nino: nino 
gryn: gryn 
people: people 
sample: samples sample 
year: year 
day: days 
press: press 
lover: lover 
scooter: scooter 
mind: mind 
rap: rap 
sound: sound 
worked: worked 
title: title 
bersetzungen: bersetzungen 
programmer: programmer 
spoil: spoil 
statue: statues 
light: lights 
chopp: chopp 
emma: emma 
amfee: amfee 
tiffany: tiffany 
gon: gon 
flow: flows 
u: u us 
lead: lead 
verified: verified 
n: n 
bonfiglio: bonfiglio 
network: network 
g: g 
small: small 
woodchuck: woodchuck 
krillin: krillin 
contemporary: contemporary 
luria: luria 
phone: phone 
hannah: hannah 
mixed: mixed 
triunfo: triunfo 
knowledge: knowledge 
seven: seven 
jr: jr 
bop: bop 
city: city 
make: make 
death: death 
line: lines 
grande: grande 
gold: gold 
brasil: brasil 
j: j 
licensing: licensing 
assistant: assistant 
german: german 
rosenberg: rosenberg 
rich: riches 
victoria: victoria 
th: th 
gimme: gimme 
mccants: mccants 
na: na 
sean: sean 
italiane: italiane 
nederland: nederlands 
julie: julie 
vertalingen: vertalingen 
say: say 
davi: davi 
ol: ol 
cartier: cartier 
forum: forum 
lookin: lookin 
traducciones: traducciones 
ryan: ryan 
said: said 
flossy: flossy 
fifth: fifth 
advertise: advertise 
naked: naked 
ai: aises ais 
many: many 
closet: closet 
add: add 
nothing: nothing 
foster: foster 
discanio: discanio 
license: license 
hillstorian: hillstorian 
understand: understand 
rather: rather 
guide: guide 
traduzione: traduzione 
bottle: bottles 
break: break 
twitter: twitter 
counting: counting 
project: projects 
royalty: royalty 
promote: promote 
bonus: bonus 
kobalt: kobalt 
therapy: therapy 
price: price 
quero: quero 
copyright: copyright 
labrae: labrae 
biggest: biggest 
job: jobs 
bold: bold 
accurate: accurate 
f: f 
umaczenie: umaczenie 
cover: cover covers 
crib: crib 
among: among 
contact: contact 
teased: teased 
girlfriend: girlfriend 
em: em 
turkish: turkish 
mannequin: mannequin 
mon: mon 
state: state 
fft: fft 
happiness: happiness 
operaci: operaci 
ml: ml 
deposit: deposits 
card: card 
also: also 
distributor: distributor 
get: get 
umaczenia: umaczenia 
mean: mean 
management: management 
polski: polski 
notorious: notorious 
translation: translations translation 
traducci: traducci 
know: knows know 
tbhitsville: tbhitsville 
scootie: scootie 
easter: easter 
jesschic: jesschic 
bersetzung: bersetzung 
anaju: anaju 
str: str 
fact: facts 
fake: fake 
dessy: dessy 
watchin: watchin 
dutch: dutch 
mand: mand 
monet: monet 
plant: plant 
thing: things 
mano: mano 
cancel: cancel 
trap: trap 
z: z 
tweeted: tweeted 
record: record records 
turn: turn 
mastering: mastering 
way: way 
emi: emi 
new: new 
allison: allison 
jet: jet 
look: look 
brandon: brandon 
vincent: vincent 
krysiuk: krysiuk 
jen: jen 
made: made 
front: front 
nah: nah 
woulda: woulda 
january: january 
ali: ali 
booth: booth 
term: terms 
beginning: beginning 
nd: nd 
thought: thought 
polskie: polskie 
klumzy: klumzy 
hair: hair 
black: black 
interpolate: interpolate 
whopper: whopper 
ariana: ariana 
god: god 
keep: keep 
sapphire: sapphire 
aise: aise 
embed: embed 
addiction: addiction 
first: first 
mixstar: mixstar 
poppin: poppin 
avex: avex 
universal: universal 
named: named 
ft: ft 
time: time 
last: last 
ever: ever 
giorgio: giorgio 
digital: digital 
hot: hot 
radio: radio 
settin: settin 
farsi: farsi 
amiah: amiah 
destroyed: destroyed 
ultimate: ultimate 
jungle: jungle 
wrong: wrong 
receive: receive 
like: like 
super: super 
distinguish: distinguish 
solve: solve 
burp: burps 
million: million 
two: two 
merrill: merrill 
string: strings 
piano: piano 
dangerous: dangerous 
wrist: wrist 
uk: uk 
source: source 
receipt: receipts 
siete: siete 
sign: sign 
q: q 
matt: matt 
gave: gave 
davis: davis 
pop: pop 
r: r 
favorite: favorite 
place: place 
bag: bag 
bennett: bennett 
vocal: vocal vocals 
chipolone: chipolone 
spanish: spanish 
performer: performer 
rucka: rucka 
llc: llc 
official: official 
tbhits: tbhits 
award: awards 
insight: insight 
gee: gee 
cia: cia 
fla: fla 
chainz: chainz 
expand: expand 
traduceri: traduceri 
big: big 
sad: sad 
must: must 
loot: loot 
natalia: natalia 
recording: recording 
hnm: hnm 
portuguese: portuguese 
mac: mac 
klein: klein 
repeating: repeating 
imagine: imagine 
castillo: castillo 
whoever: whoever 
derek: derek 
track: track 
alfredo: alfredo 
marcus: marcus 
confirmed: confirmed 
revealed: revealed 
plate: plate 
love: love 
smile: smile 
meme: meme 
behind: behind 
publishing: publishing 
set: set 
iii: iii 
bubble: bubbles 
dansk: dansk 
sterling: sterling 
promessa: promessa 
sam: sam 
miller: miller 
greek: greek 
heartless: heartless 
bigdrippa: bigdrippa 
date: date 
girl: girls 
parx: parx 
platinum: platinum 
hollywood: hollywood 
c: c 
mikey: mikey 
eu: eu 
thanks: thanks 
skin: skin 
megamix: megamix 
beef: beef 
hugo: hugo 
yep: yep 
logic: logic 
alisa: alisa 
dog: dog 
cocktail: cocktail 
mashup: mashup 
adamusic: adamusic 
flores: flores 
h: h 
individual: individual 
certification: certifications 
respect: respect 
owsla: owsla 
single: single 
shoot: shoot 
smoke: smoke 
aaron: aaron 
billy: billy 
sutnick: sutnick 
coordinator: coordinator 
tattoo: tattoos 
personal: personal 
timer: timer 
pink: pink 
transcription: transcription 
chart: charts 
might: might 
hard: hard 
pre: pre 
idea: idea 
yeah: yeah 
aiono: aiono 
brian: brian 
traktivist: traktivist 
warner: warner 
stacked: stacked 
delusion: delusion 
store: store 
sing: sing 
italian: italian 
music: music 
l: l 
live: live 
business: business 
bottom: bottoms 
question: question 
producer: producer 
tjay: tjay 
alexa: alexa 
drop: drop 
shop: shop 
espa: espa 
produced: produced 
learn: learn 
car: car 
owner: owners 
recorded: recorded 
executive: executive 
st: st 
italiana: italiana 
dj: dj 
scholar: scholars 
heesters: heesters 
boxy: boxy 
december: december 
goldstein: goldstein 
seen: seen 
interpolation: interpolations 
alaina: alaina 
as: ass 
gz: gz 
version: version 
scary: scary 
nikito: nikito 
traduzioni: traduzioni 
entertainment: entertainment 
danish: danish 
egg: eggs 
net: net 
hally: hally 
italiano: italiano 
moonlight: moonlight 
