fear: fear 
damn: damn 
talk: talk 
thutmose: thutmose 
per: per 
kaisson: kaisson 
bm: bm 
italic: italics 
bitch: bitch 
bonson: bonson 
tradu: tradu 
phaserzz: phaserzz 
chorus: chorus 
note: note 
still: still 
crime: crime 
section: section 
girl: girl 
nobody: nobody 
cristian: cristian 
let: let 
nigga: nigga 
terrell: terrell 
season: season 
ted: ted 
baker: baker 
parmesan: parmesan 
deutsch: deutsch 
couch: couch 
hate: hate 
good: good 
ac: ac 
remixes: remixes 
little: little 
mark: marks 
released: released 
reference: reference 
movie: movie 
collection: collection 
purple: purple 
dis: disses 
use: use 
cracker: cracker 
congratulation: congratulations 
corp: corp 
hybrid: hybrid 
lyric: lyrics lyric 
bad: bad 
deep: deep 
influenced: influenced 
guitar: guitar 
put: put 
eviatar: eviatar 
grey: grey 
information: information 
loyalty: loyalty 
boze: boze 
plus: pluss 
boy: boy 
rahamim: rahamim 
pint: pint 
azerrz: azerrz 
charting: charting 
crazy: crazy 
w: w 
scherrer: scherrer 
world: world 
holding: holdings 
humility: humility 
rewind: rewind 
making: making 
fletcher: fletcher 
summermash: summermash 
rick: rick 
line: line lines 
debuting: debuting 
unleshed: unleshed 
v: v 
tucker: tucker 
baby: baby 
page: page 
bpm: bpm 
stone: stone 
soundclown: soundclown 
back: back 
ironically: ironically 
beyonc: beyonc 
ty: ty 
alex: alex 
frontin: frontin 
banging: banging 
rbaycan: rbaycan 
nathan: nathan 
kal: kal 
privacy: privacy 
amaze: amaze 
artist: artists 
adam: adams 
linking: linking 
analyst: analysts 
rinat: rinat 
ayy: ayy 
directed: directed 
kelly: kelly 
pimp: pimp 
bender: bender 
biffty: biffty 
bout: bout 
benji: benji 
token: token 
dane: dane 
justpierre: justpierre 
extra: extras 
buy: buy 
another: another 
humble: humble 
dick: dick 
eviri: eviri 
earworm: earworm 
answer: answer 
bovine: bovine 
thinkin: thinkin 
share: share 
classiques: classiques 
sandwich: sandwiches 
gang: gang 
uncle: uncle 
week: week 
second: second 
never: never 
highest: highest 
jamie: jamie 
account: account 
k: k 
playa: playa 
co: co 
cz: cz 
ke: ke 
kanskaart: kanskaart 
promotional: promotional 
guideline: guidelines 
stretch: stretch 
check: check 
song: song songs 
credit: credits 
cheese: cheese 
countin: countin 
polo: polo 
friday: friday 
deutsche: deutsche 
pinkney: pinkney 
tetri: tetris 
beware: beware 
admitted: admitted 
man: man 
feature: features 
represent: represent 
block: block 
even: even 
keneddythedon: keneddythedon 
engineer: engineer 
extended: extended 
bae: bae 
post: post 
un: un 
battle: battle 
mutombo: mutombo 
rabineau: rabineau 
money: money 
soup: soup 
songview: songview 
dwa: dwa 
nwigwe: nwigwe 
comment: comment comments 
hardcore: hardcore 
mental: mental 
element: element 
atol: atol 
photoshop: photoshop 
wii: wii 
contributor: contributor contributors 
yung: yung 
hi: hi 
deebo: deebo 
greatest: greatest 
read: read 
filmed: filmed 
lil: lil 
xxx: xxx 
petty: petty 
part: parts part 
free: free 
header: headers 
right: right rights 
quit: quit 
bicycle: bicycle 
ask: ask 
performance: performance 
written: written 
va: va 
format: format 
phrase: phrase 
vocalist: vocalists 
developer: developers 
alcohol: alcohol 
rbaycanca: rbaycanca 
expensive: expensive 
wagmi: wagmi 
o: os 
sucko: sucko 
phonographic: phonographic 
director: director 
level: levels 
garfo: garfo 
remix: remix 
pull: pull 
il: il 
rk: rk 
mixing: mixing 
view: view 
style: style 
max: max 
musical: musical 
tyler: tyler 
visit: visit 
tobe: tobe 
counterfeit: counterfeits counterfeit 
lust: lust 
created: created 
billboard: billboard 
shit: shit 
flee: flee 
asxacid: asxacid 
june: june 
trump: trump 
theme: theme 
p: p 
ozymandias: ozymandias 
stepan: stepan 
ooh: ooh 
play: play 
allowance: allowances 
dax: dax 
kool: kool 
call: call 
broken: broken 
different: different 
united: united 
devvon: devvon 
remember: remember 
afro: afro 
vida: vida 
bright: bright 
streetz: streetz 
e: es e 
video: videos video 
concept: concept 
pussy: pussy 
shown: shown 
mf: mf 
featured: featured 
cool: cool 
light: light 
flow: flow 
bart: bart 
ride: ride 
word: words 
neguse: neguse 
overall: overall 
label: label 
cinch: cinch 
roule: roule 
parody: parody 
lamborghini: lamborghini 
character: character 
maxwell: maxwell 
hol: hol 
michael: michael 
ascap: ascap 
al: al 
duki: duki 
coast: coast 
type: type 
duckworth: duckworth 
mosquito: mosquito 
release: release 
b: b 
primera: primera 
banx: banx 
clarkson: clarkson 
minecraft: minecraft 
pluffaduff: pluffaduff 
ripper: ripper 
chainsmokers: chainsmokers 
paged: paged 
schaeffer: schaeffer 
fleisner: fleisner 
pray: pray 
urban: urban 
group: group 
leshurr: leshurr 
jason: jason 
bmi: bmi 
together: together 
intro: intro 
french: french 
earth: earth 
subliminal: subliminal 
representation: representation 
popular: popular 
one: one 
brown: brown 
gallegos: gallegos 
transcriber: transcribers 
ramon: ramon 
green: green 
x: x 
night: night 
bullet: bullet 
couture: couture 
prior: prior 
sus: sus 
policy: policy 
publisher: publisher 
sa: sa 
compressor: compressor 
competition: competition 
head: heads 
kendrick: kendrick 
tamerlane: tamerlane 
jasiah: jasiah 
leaker: leakers 
etc: etc 
sell: sell 
could: could 
portugu: portugu 
baklvn: baklvn 
az: az 
paris: paris 
blood: bloods blood 
summer: summer 
sandman: sandman 
annotation: annotation 
used: used 
realest: realest 
life: lives life 
downin: downin 
daymanoursavior: daymanoursavior 
bank: bank 
pm: pm 
minimessi: minimessi 
jazz: jazz 
polish: polish 
debuted: debuted 
trouble: trouble 
trey: trey 
richard: richard 
deleto: deleto 
later: later 
told: told 
genius: genius 
ethan: ethan 
legion: legion 
somethin: somethin 
grundle: grundle 
sample: samples sample 
tu: tu 
press: press 
vmas: vmas 
russian: russian 
modest: modest 
freestyle: freestyle 
nosfe: nosfe 
rap: rap 
sound: sound 
year: years 
burninghand: burninghand 
mike: mike 
bersetzungen: bersetzungen 
meyers: meyers 
issac: issac 
u: u us 
start: start 
ear: ear 
mama: mama 
verified: verified 
challenge: challenges 
n: n 
simz: simz 
naomi: naomi 
rmx: rmx 
g: g 
tired: tired 
diem: diem 
tarantola: tarantola 
show: show 
mixed: mixed 
left: left 
pride: pride 
weedim: weedim 
knowledge: knowledge 
city: city 
make: make 
ar: ar 
west: west 
death: death 
ave: ave 
brasil: brasil 
licensing: licensing 
boca: boca 
j: j 
german: german 
yo: yo 
th: th 
chart: chart charts 
boo: boo 
ol: ol 
devil: devil 
forum: forum 
robinson: robinson 
traducciones: traducciones 
ryan: ryan 
said: said 
paradox: paradox 
riding: riding 
advertise: advertise 
dawg: dawg 
campa: campa 
watch: watch 
budouble: budouble 
malone: malone 
add: add 
akthesavior: akthesavior 
taste: tastes taste 
azerbaijan: azerbaijan 
kig: kig 
blew: blew 
spiral: spiral 
piss: piss 
fact: fact facts 
understand: understand 
guide: guide 
rain: rain 
drip: drip 
break: break 
funk: funk 
medley: medley 
boom: boom 
brasel: brasel 
promote: promote 
hip: hip 
fucking: fucking 
kobalt: kobalt 
aundre: aundre 
copyright: copyright 
skrillex: skrillex 
biggest: biggest 
job: jobs 
bold: bold 
saca: saca 
soprano: soprano 
apandah: apandah 
f: f 
everyone: everyone 
umaczenie: umaczenie 
valourian: valourian 
cover: cover covers 
chappell: chappell 
contact: contact 
viri: viri 
em: em 
turkish: turkish 
mon: mon 
state: state 
dragon: dragons 
yaminobahamut: yaminobahamut 
similar: similar 
azure: azure 
ml: ml 
mcphillip: mcphillip 
mask: mask 
lite: lite 
production: production 
benz: benz 
also: also 
get: get 
umaczenia: umaczenia 
decade: decade 
polski: polski 
natural: natural 
sanislo: sanislo 
kill: kill 
translation: translations translation 
homsky: homsky 
traducci: traducci 
lotto: lotto 
parte: parte 
code: code 
goat: goats 
sitting: sitting 
conway: conway 
final: final 
bersetzung: bersetzung 
pulsar: pulsar 
abushaev: abushaev 
mercedes: mercedes 
mitsfit: mitsfit 
humb: humb 
aldi: aldi 
tar: tar 
ter: ter 
aid: aid 
youtube: youtube 
leonardo: leonardo 
chris: chris 
cancel: cancel 
gr: gr 
trap: trap 
paystub: paystub 
z: z 
singe: singe 
high: high 
med: meds med 
bootleg: bootleg 
mode: mode 
turn: turn 
syrup: syrup 
way: way 
new: new 
us: uss 
project: project 
homecoming: homecoming 
welcome: welcome 
made: made 
top: top 
da: da 
ali: ali 
interscope: interscope 
term: terms 
departure: departure 
polskie: polskie 
single: singles single 
take: take 
launzera: launzera 
display: displays 
black: black 
biyombo: biyombo 
lamar: lamar 
interpolate: interpolate 
whopper: whopper 
kythre: kythre 
mixtape: mixtape 
drummer: drummers drummer 
grant: grants 
god: god 
sit: sit 
james: james 
hop: hop 
keep: keep 
la: la 
braggadocious: braggadocious 
embed: embed 
disease: disease 
whole: whole 
first: first 
dna: dna 
pandorum: pandorum 
stroke: stroke 
ft: ft 
shape: shape 
time: time 
last: last 
aftermath: aftermath 
donald: donald 
ever: ever 
homies: homies 
galaxy: galaxy 
collaborated: collaborated 
hot: hot 
lie: lie 
neighborhood: neighborhood 
since: since 
ultimate: ultimate 
william: william 
eighteen: eighteen 
jungle: jungle 
vitamin: vitamin 
string: string 
loqiemean: loqiemean 
like: like 
distinguish: distinguish 
folk: folks 
vient: vient 
piano: piano 
breakdown: breakdown 
misfit: misfit 
fuck: fuck 
riff: riff 
sick: sick 
went: went 
slide: slide 
source: source 
sign: sign 
flyingkitty: flyingkitty 
justin: justin 
matt: matt 
brien: brien 
q: q 
day: day 
stay: stay 
pop: pop 
r: r 
quartet: quartet 
industry: industry 
spanish: spanish 
machine: machine 
force: forces 
bass: bass 
llc: llc 
ross: ross 
seems: seems 
award: awards award 
insight: insight 
working: working 
speed: speed 
viral: viral 
ya: ya 
obama: obama 
expand: expand 
vinci: vinci 
resist: resist 
big: big 
alarm: alarm 
snak: snak 
feel: feel 
april: april 
banai: banai 
joined: joined 
yah: yah 
crisis: crisis 
portuguese: portuguese 
dave: dave 
zhekandos: zhekandos 
mumble: mumble 
fabricate: fabricate 
repeating: repeating 
imagine: imagine 
christian: christian 
track: track 
teddy: teddy 
bieber: bieber 
rc: rc 
love: love 
hit: hit 
disstrack: disstrack 
meme: meme 
fakin: fakin 
publishing: publishing 
ne: ne 
imagery: imagery 
soul: soul 
date: date 
frame: frame 
priest: priest 
c: c 
megamix: megamix 
navia: navia 
ak: ak 
conscious: conscious 
march: march 
te: tes 
mashup: mashup 
painting: painting 
sock: socks 
h: h 
individual: individual 
tzanua: tzanua 
stage: stage 
slumpy: slumpy 
playin: playin 
troy: troy 
robe: robes 
thus: thus 
previous: previous 
know: know 
solo: solo 
perfect: perfect 
heart: heart 
personal: personal 
baller: baller 
transcription: transcription 
poupon: poupon 
might: might 
eminem: eminem 
hard: hard 
sd: sd 
cher: cher 
happens: happens 
yeah: yeah 
baum: baum 
canadiana: canadiana 
full: full 
gangsta: gangsta 
warner: warner 
record: records 
vich: vich 
finesse: finesse 
supper: supper 
music: music 
l: l 
comedy: comedy 
butterfly: butterfly 
abrazaste: abrazaste 
mtv: mtv 
zagranis: zagranis 
live: live 
question: question 
orange: orange 
tylerk: tylerk 
producer: producer 
speak: speak 
gotta: gotta 
lixo: lixo 
drop: drop 
shop: shop 
espa: espa 
lady: lady 
produced: produced 
learn: learn 
king: king 
prny: prny 
tag: tags 
verse: verse 
enactment: enactment 
maniac: maniac 
lj: lj 
awy: awy 
juxtaposing: juxtaposing 
johnyboy: johnyboy 
moving: moving 
elaborate: elaborate 
dj: dj 
scholar: scholars 
fire: fire 
viva: viva 
fuckin: fuckin 
evian: evian 
religious: religious 
as: ass 
version: version 
accountant: accountant 
entertainment: entertainment 
sh: sh 
beat: beat 
pryor: pryor 
