nico: nico 
impacted: impacted 
nightmare: nightmare 
bored: bored 
isosine: isosine 
otamatone: otamatone 
italic: italics 
bitch: bitch 
tradu: tradu 
around: around 
chorus: chorus 
grave: grave 
thought: thoughts thought 
peaked: peaked 
still: still 
section: section 
nederlandse: nederlandse 
found: found 
betrayed: betrayed 
nobody: nobody 
let: let 
kiosko: kiosko 
pr: prs 
terrell: terrell 
chicago: chicago 
deutsch: deutsch 
hate: hate 
good: good 
joshy: joshy 
okay: okay 
remixes: remixes 
mash: mash 
andrew: andrew 
koch: koch 
te: te 
weep: weep 
kyle: kyle 
traductions: traductions 
trogan: trogan 
rez: rez 
collection: collection 
notimebeatz: notimebeatz 
use: use 
cutenboi: cutenboi 
lyric: lyrics lyric 
touch: touch 
bad: bad 
matxeus: matxeus 
grandkids: grandkids 
forget: forget 
outro: outro 
yayayi: yayayi 
put: put 
information: information 
demo: demo 
tear: tears 
boy: boy 
certified: certified 
includes: includes 
kid: kids kid 
azerrz: azerrz 
personnel: personnel 
robux: robux 
college: college 
uzi: uzi 
world: world 
holding: holdings 
w: w 
traduction: traduction 
oh: oh 
v: v 
urgent: urgent 
codeine: codeine 
sonna: sonna 
bogus: bogus 
vertaling: vertaling 
back: back 
halsey: halsey 
much: much 
ele: ele 
alex: alex 
fortnite: fortnite 
juandale: juandale 
privacy: privacy 
artist: artists artist 
want: want 
writing: writing 
secretos: secretos 
nonstop: nonstop 
loved: loved 
go: go 
beat: beats 
luvariez: luvariez 
knew: knew 
aware: aware 
fall: fall 
bro: bro 
buy: buy 
another: another 
explores: explores 
juice: juice 
rainbow: rainbow 
dont: dont 
eviri: eviri 
kidz: kidz 
earworm: earworm 
move: move 
bed: bed 
answer: answer 
beautiful: beautiful 
share: share 
jon: jon 
pay: pay 
ache: ache 
rip: rip 
week: week 
mora: mora 
kvneki: kvneki 
k: k 
guideline: guidelines 
check: check 
song: song songs 
credit: credits 
hebrew: hebrew 
foy: foy 
deutsche: deutsche 
cole: cole 
upset: upset 
iclander: iclander 
man: man 
experience: experiences experience 
going: going 
blackwood: blackwood 
mashups: mashups 
even: even 
engineer: engineer 
described: described 
thing: thing 
post: post 
rich: rich 
banana: bananas 
liar: liar 
schwartz: schwartz 
everything: everything 
money: money 
el: el 
bryant: bryant 
roblox: roblox 
real: real 
songview: songview 
comment: comment comments 
mental: mental 
romanian: romanian 
band: band 
personally: personally 
contributor: contributor contributors 
stem: stem 
yung: yung 
bbc: bbc 
hi: hi 
read: read 
lil: lil 
despite: despite 
riaa: riaa 
part: parts part 
health: health 
past: past 
header: headers 
dover: dover 
jack: jack 
ask: ask 
performance: performance performances 
written: written 
format: format 
vocalist: vocalists 
lapiz: lapiz 
developer: developers 
road: road 
bridge: bridge 
revenue: revenue 
expensive: expensive 
july: july 
rom: rom 
huntaps: huntaps 
hairline: hairline 
emo: emo 
mine: mines 
bmg: bmg 
phonographic: phonographic 
director: director 
remix: remix 
die: die 
wrld: wrld 
rk: rk 
mixing: mixing 
electric: electric 
jexf: jexf 
omb: omb 
view: view 
become: become 
dead: dead 
closure: closure 
que: que 
visit: visit 
tyler: tyler 
musical: musical 
candidate: candidates 
created: created 
billboard: billboard 
shit: shit 
studio: studio studios 
head: head 
p: p 
beheaded: beheaded 
see: see 
keith: keith 
uh: uh 
brothern: brothern 
call: call 
alexander: alexander 
ticklemytip: ticklemytip 
broken: broken 
different: different 
cam: cam 
dkg: dkg 
lucide: lucide 
sings: sings 
united: united 
devvon: devvon 
forgive: forgive 
vida: vida 
star: star 
hour: hours 
rock: rock 
kaz: kaz 
enough: enough 
e: es e 
video: videos video 
xaev: xaev 
elevatormag: elevatormag 
featured: featured 
flow: flow 
taylor: taylor 
fia: fia 
tag: tags 
smelly: smelly 
label: label 
issue: issue 
parody: parody parodys 
sting: sting 
matter: matter 
bassetfilms: bassetfilms 
ascap: ascap 
al: al 
us: uses 
ba: ba 
got: got 
oklahoma: oklahoma 
lucid: lucid 
type: type 
dnasty: dnasty 
referenced: referenced 
monster: monster 
release: release 
b: b 
prescription: prescriptions 
minecraft: minecraft 
pluffaduff: pluffaduff 
evil: evil 
right: rights 
anguish: anguish 
yellowcard: yellowcard 
kgscarred: kgscarred 
group: group 
traducere: traducere 
bmi: bmi 
filing: filing 
rmc: rmc 
tmmrw: tmmrw 
intro: intro 
french: french 
quarterpounder: quarterpounder 
shadow: shadows shadow 
popular: popular 
one: one 
feel: feels feel 
x: x 
transcriber: transcribers 
osama: osama 
elevate: elevate 
following: following 
deleted: deleted 
away: away 
siivagunner: siivagunner 
thirty: thirty 
peace: peace 
ava: ava 
challenge: challenge 
lofi: lofi 
interpolation: interpolation interpolations 
le: le 
heartbreak: heartbreak 
policy: policy 
especially: especially 
publisher: publisher 
dream: dreams dream 
seeing: seeing 
production: productions production 
majinboof: majinboof 
tempo: tempo 
etc: etc 
sell: sell 
friend: friends 
could: could 
fran: fran 
cardcaptorxp: cardcaptorxp 
portugu: portugu 
shitty: shitty 
foot: feet 
sep: sep 
anthem: anthem 
edit: edit 
frustration: frustration 
process: process 
annotation: annotation 
used: used 
over: overs 
wonder: wonder 
mega: mega 
october: october 
molina: molina 
company: company 
life: lives life 
daymanoursavior: daymanoursavior 
jinz: jinz 
reptilelegityt: reptilelegityt 
point: point 
worst: worst 
shamana: shamana 
ttelse: ttelse 
david: david 
later: later 
told: told 
person: person 
genius: genius 
figured: figured 
nick: nick 
sega: sega 
yungblud: yungblud 
im: im 
flight: flight 
lost: lost 
spongebobs: spongebobs 
sample: samples sample 
year: year 
people: people 
engo: engo 
emanthekid: emanthekid 
listenin: listenin 
blue: blue 
press: press 
cut: cut 
lover: lover 
russian: russian 
freestyle: freestyle 
rap: rap 
bittersweet: bittersweet 
steerpike: steerpike 
pt: pt 
mike: mike 
jonny: jonny 
bersetzungen: bersetzungen 
vict: vict 
eleven: eleven 
asapolis: asapolis 
aa: aa 
taz: taz 
else: else 
u: u us 
bo: bo 
juicewrld: juicewrld 
verified: verified 
n: n 
g: g 
face: face 
tweet: tweets 
phone: phone 
casket: casket 
plastic: plastic 
melly: melly 
left: left 
serpent: serpent 
room: room 
mar: mars 
stewie: stewie 
knowledge: knowledge 
begin: begin 
artwork: artwork 
bop: bop 
landing: landing 
wedding: wedding 
make: make 
talking: talking 
analogy: analogy 
magnetic: magnetic 
death: death 
bar: bars 
line: lines 
brasil: brasil 
anuel: anuel 
licensing: licensing 
j: j 
danny: danny 
german: german 
griffin: griffin 
fighting: fighting 
chart: chart charts 
submarine: submarine 
italiane: italiane 
nederland: nederlands 
vertalingen: vertalingen 
dreamer: dreamer 
true: true 
awesome: awesome 
ol: ol 
change: change 
sonic: sonic 
handle: handles 
forum: forum 
interpolated: interpolated 
traducciones: traducciones 
said: said 
inside: inside 
cry: cry 
nme: nme 
advertise: advertise 
exum: exum 
ai: aises ais 
editor: editor 
many: many 
dominio: dominio 
utorrent: utorrent 
watch: watch 
lyrical: lyrical 
malone: malone 
add: add 
gaining: gaining 
eastside: eastside 
poo: poo 
sumi: sumi 
wind: wind 
fact: fact facts 
understand: understand 
guide: guide 
whenever: whenever 
drastic: drastic 
traduzione: traduzione 
break: break 
chord: chords 
bleu: bleu 
medley: medley 
school: school 
promote: promote 
alternate: alternate 
kobalt: kobalt 
consciousness: consciousness 
division: divisions 
melody: melody 
copyright: copyright 
hendrix: hendrix 
biggest: biggest 
job: jobs 
nasir: nasir 
bold: bold 
trip: trip 
hood: hood 
link: link 
bibby: bibby 
ame: ame 
f: f 
series: series 
photography: photography 
old: old 
cover: cover covers 
backyard: backyard 
perkas: perkas 
steadicam: steadicam 
maj: maj 
saved: saved 
contact: contact 
situation: situation 
em: em 
turkish: turkish 
initial: initial 
state: state 
collaborator: collaborator 
ykey: ykey 
lemonade: lemonade 
instead: instead 
ml: ml 
dom: dom 
touching: touching 
kie: kie 
mira: mira 
art: art 
mask: mask 
lilt: lilt 
alone: alone 
also: also 
distributor: distributor 
eye: eyes eye 
painmaker: painmaker 
decade: decade 
translation: translations translation 
dropout: dropout 
jake: jake 
traducci: traducci 
goat: goats 
sitting: sitting 
emirp: emirp 
bersetzung: bersetzung 
pause: pause 
cup: cups 
fake: fake 
end: end 
ending: ending 
dutch: dutch 
tangled: tangled 
control: control 
cancel: cancel 
controlling: controlling 
reaction: reaction 
trap: trap 
ghxst: ghxst 
bayley: bayley 
z: z 
tweeted: tweeted 
pokorney: pokorney 
nonsense: nonsense 
juiceworld: juiceworld 
mastering: mastering 
way: way ways 
emi: emi 
buda: buda 
ysn: ysn 
look: look 
lanelanelane: lanelanelane 
vincent: vincent 
party: party 
made: made 
top: top 
da: da 
godisalucidheartshapedbox: godisalucidheartshapedbox 
mix: mix 
interscope: interscope 
term: terms 
without: without 
popularity: popularity 
refers: refers 
estoy: estoy 
take: take 
replace: replace 
original: original 
tok: tok 
berges: berges 
og: og 
interpolate: interpolate 
rvssian: rvssian 
tik: tik 
seek: seeks 
hy: hy 
god: god 
vert: vert 
keep: keep 
la: la 
blow: blow 
trancamos: trancamos 
beauty: beauty 
sapphire: sapphire 
embed: embed 
aise: aise 
fuck: fucks fuck 
first: first 
durk: durk 
luckhaos: luckhaos 
dominic: dominic 
universal: universal 
shape: shape 
grade: grade 
ft: ft 
last: last 
ever: ever 
telling: telling 
galaxy: galaxy 
fame: fame 
hot: hot 
radio: radio 
farsi: farsi 
wow: wow 
since: since 
ultimate: ultimate 
dreaming: dreaming 
like: like 
super: super 
distinguish: distinguish 
guy: guy 
avoid: avoid 
awarded: awarded 
timmon: timmon 
two: two 
better: better 
dire: dire 
demon: demons 
dangerous: dangerous 
frao: frao 
huh: huh 
path: paths 
prettiest: prettiest 
royal: royal 
frequent: frequent 
jourdan: jourdan 
sinf: sinf 
uk: uk 
source: source 
leave: leave 
need: need 
godo: godo 
sign: sign 
tre: tre 
q: q 
gave: gave 
interpretation: interpretation 
pop: pop 
r: r rs 
seized: seized 
siento: siento 
bennett: bennett 
thinking: thinking 
done: done 
spanish: spanish 
angry: angry 
smith: smith 
dopamine: dopamine 
dia: dia 
llc: llc 
seems: seems 
royalty: royalties 
lounge: lounge 
insight: insight 
million: millions 
agane: agane 
bateman: bateman 
always: always 
expand: expand 
traduceri: traduceri 
must: must 
sad: sad 
recording: recording 
pain: pain 
peur: peur 
khalid: khalid 
ysb: ysb 
recognize: recognize 
experiencing: experiencing 
portuguese: portuguese 
may: may 
poopy: poopy 
repeating: repeating 
enviyon: enviyon 
dark: dark 
track: track 
unlikely: unlikely 
herbo: herbo 
gamers: gamers 
love: love 
hit: hit 
easier: easier 
dnd: dnd 
meme: meme 
vxlious: vxlious 
publishing: publishing 
teflon: teflon 
dansk: dansk 
pewdiepie: pewdiepie 
owe: owe 
miller: miller 
soul: soul 
date: date 
libra: libra 
girl: girls 
ex: ex 
platinum: platinum 
gamer: gamer 
frijo: frijo 
finny: finny 
c: c 
skit: skit 
megamix: megamix 
rio: rio 
cash: cash 
plug: plug 
xo: xo 
inspired: inspired 
march: march 
blade: blade 
color: colors 
ur: ur 
mashup: mashup 
interview: interview 
h: h 
individual: individual 
lawsuit: lawsuit 
muerto: muerto 
stackonit: stackonit 
mistake: mistakes 
bell: bell 
everybody: everybody 
four: four 
lifestyle: lifestyle 
adding: adding 
know: know 
fck: fck 
heart: heart 
personal: personal 
transcription: transcription 
might: might 
hard: hard 
idea: idea 
yeah: yeah 
turnin: turnin 
aiono: aiono 
snow: snow 
jenay: jenay 
dansyafi: dansyafi 
full: full 
therealsullyg: therealsullyg 
ppl: ppl 
record: records 
cimorelli: cimorelli 
content: contents 
italian: italian 
music: music 
l: l 
leon: leon 
really: really 
darell: darell 
lee: lee 
outta: outta 
falling: falling 
live: live 
slowly: slowly 
blah: blah 
moon: moon 
aiteda: aiteda 
amai: amai 
question: question 
second: seconds 
producer: producer 
cahleh: cahleh 
drop: drop 
gotta: gotta 
lixo: lixo 
shop: shop 
espa: espa 
produced: produced 
learn: learn 
vezzys: vezzys 
king: king 
hilyxs: hilyxs 
miky: miky 
ring: ring 
listened: listened 
verse: verse 
woodz: woodz 
young: young 
recorded: recorded 
italiana: italiana 
dorex: dorex 
censor: censor 
dj: dj 
scholar: scholars 
drake: drake 
fire: fire 
viva: viva 
armed: armed 
par: par 
cannot: cannot 
download: download 
version: version 
rele: rele 
traduzioni: traduzioni 
icrywhenimsober: icrywhenimsober 
myers: myers 
danish: danish 
italiano: italiano 
moonlight: moonlight 
special: special 
