talk: talk 
arson: arson 
tradu: tradu 
famous: famous 
italic: italics 
model: model 
chorus: chorus 
section: section 
girl: girl girls 
nobody: nobody 
ye: ye 
let: let 
loud: loud 
february: february 
feedback: feedback 
tch: tch 
vers: vers 
chicago: chicago 
credited: credited 
hate: hate 
prayer: prayer 
remixes: remixes 
cyhi: cyhi 
andrew: andrew 
traductions: traductions 
collection: collection 
bandz: bandz 
tell: tell 
use: use 
common: common 
svenska: svenska 
elsie: elsie 
corp: corp 
lyric: lyrics lyric 
ttning: ttning 
socially: socially 
vann: vann 
information: information 
rapper: rapper 
demo: demo 
ameer: ameer 
boy: boy 
redan: redan 
minimal: minimal 
w: w 
wave: waves wave 
world: world 
holding: holdings 
making: making 
rick: rick 
line: line lines 
traduction: traduction 
oh: oh 
thug: thug 
v: v 
fml: fml 
baby: baby 
ha: ha 
cmoney: cmoney 
relate: relate 
wanna: wanna 
hand: hands hand 
wake: wake 
myne: myne 
pastor: pastor 
concord: concord 
privacy: privacy 
artist: artists 
want: want 
tag: tag tags 
kelly: kelly 
blaccmass: blaccmass 
loved: loved 
matter: matters 
thr: thr 
feb: feb 
funny: funny 
another: another 
jang: jang 
tribeca: tribeca 
ubem: ubem 
mallet: mallet 
dick: dick 
eviri: eviri 
answer: answer 
beautiful: beautiful 
share: share 
bleach: bleach 
k: k 
ngoma: ngoma 
co: co 
malik: malik 
ke: ke 
guideline: guidelines 
gay: gay 
stretch: stretch 
check: check 
song: song songs 
credit: credits 
love: loves love 
notgrass: notgrass 
blackwood: blackwood 
even: even 
engineer: engineer 
andy: andy 
comedian: comedian 
rubin: rubin 
shawn: shawn 
real: real 
jabriel: jabriel 
aura: aura 
comment: comment comments 
wrote: wrote 
shawny: shawny 
crushed: crushed 
contributor: contributor contributors 
donda: donda 
stretching: stretching 
read: read 
jerome: jerome 
word: word 
meme: memes 
lil: lil 
despite: despite 
english: english 
riaa: riaa 
part: parts part 
nd: nds 
met: met 
next: next 
header: headers 
ask: ask 
written: written 
stuff: stuff 
performance: performance 
format: format 
vocalist: vocalists 
service: service 
american: american 
developer: developers 
samo: samo 
heat: heat 
party: parties 
boogiedown: boogiedown 
necessarily: necessarily 
bmg: bmg 
remix: remix 
boolean: boolean 
opening: opening 
rk: rk 
instigated: instigated 
mixing: mixing 
sunday: sunday 
writes: writes 
fade: fade 
view: view 
musical: musical 
visit: visit 
created: created 
boomin: boomin 
rondor: rondor 
studio: studio 
jam: jam 
power: power 
p: p 
marroquin: marroquin 
uh: uh 
whether: whether 
bleached: bleached 
broken: broken 
different: different 
desire: desire 
vida: vida 
hour: hours 
rock: rock 
charlie: charlie 
e: es e 
video: videos 
featured: featured 
light: light lights 
variable: variable 
nothin: nothin 
label: label 
mc: mc 
spedup: spedup 
keyboard: keyboards 
island: island 
michael: michael 
ascap: ascap 
al: al 
funnybone: funnybone 
fenix: fenix 
metro: metro 
george: george 
type: type 
b: b 
release: release 
tor: tor 
right: rights 
vision: vision 
dank: dank 
group: group 
bmi: bmi 
papa: papa 
intro: intro 
french: french 
svensk: svensk 
x: x 
one: one 
transcriber: transcribers 
djds: djds 
following: following 
lot: lot 
mario: mario 
policy: policy 
stretched: stretched 
publisher: publisher 
future: future 
submit: submit 
tamerlane: tamerlane 
kendrick: kendrick 
lonely: lonely 
slim: slim 
choir: choir 
etc: etc 
sell: sell 
could: could 
friend: friends 
fran: fran 
portugu: portugu 
writer: writer 
wolf: wolves 
barrett: barrett 
annotation: annotation 
mega: mega 
case: case 
listening: listening 
father: father 
polish: polish 
best: best 
david: david 
image: image 
genius: genius 
somethin: somethin 
agc: agc 
amra: amra 
people: people 
featuring: featuring 
sample: samples sample 
press: press 
freestyle: freestyle 
rap: rap 
sound: sound 
ultralight: ultralight 
pt: pt 
mike: mike 
desiigner: desiigner 
babe: babe 
else: else 
gon: gon 
u: u us 
start: start 
mornin: mornin 
notepad: notepad 
bassboosted: bassboosted 
verified: verified 
n: n 
ritter: ritter 
g: g 
help: help 
baldoyob: baldoyob 
show: show 
left: left 
dawson: dawson 
exposing: exposing 
mar: mars 
asshole: asshole 
pride: pride 
sum: sum 
every: every 
knowledge: knowledge 
west: west 
death: death 
weird: weird 
licensing: licensing 
brasil: brasil 
j: j 
member: members 
sony: sony 
life: life 
na: na 
gimme: gimme 
binladen: binladen 
italiane: italiane 
true: true 
say: say 
pablo: pablo 
ol: ol 
forum: forum 
lookin: lookin 
kristian: kristian 
manny: manny 
squidward: squidward 
traducciones: traducciones 
said: said 
advertise: advertise 
ai: aises ais 
additional: additional 
add: add 
nothing: nothing 
swedish: swedish 
dean: dean 
understand: understand 
guide: guide 
traduzione: traduzione 
please: please 
london: london 
promote: promote 
reflects: reflects 
kobalt: kobalt 
price: price 
job: jobs 
copyright: copyright 
biggest: biggest 
bold: bold 
dorian: dorian 
seinfeld: seinfeld 
f: f 
umaczenie: umaczenie 
shirt: shirt 
chappell: chappell 
contact: contact 
em: em 
turkish: turkish 
morning: morning 
ricci: ricci 
ml: ml 
production: production 
recording: recordings recording 
pluto: pluto 
ita: ita 
also: also 
get: get 
umaczenia: umaczenia 
shooter: shooter 
management: management 
tentacle: tentacles 
translation: translations translation 
traducci: traducci 
irving: irving 
marathon: marathon 
nightcore: nightcore 
str: str 
fact: facts 
end: end 
def: def 
gecs: gecs 
youtube: youtube 
low: low 
cancel: cancel 
lido: lido 
trap: trap 
z: z 
high: high 
solar: solar 
turn: turn 
way: way ways 
popularized: popularized 
emi: emi 
worried: worried 
new: new 
randagio: randagio 
realizes: realizes 
cudi: cudi 
strech: strech 
noah: noah 
term: terms 
polskie: polskie 
surffffeeeeer: surffffeeeeer 
take: take 
jlol: jlol 
clever: clever 
lamar: lamar 
chance: chance 
tune: tunes 
og: og 
interpolate: interpolate 
latinautor: latinautor 
argument: argument 
thanky: thanky 
god: god 
la: la 
aise: aise 
embed: embed 
allen: allen 
universal: universal 
ft: ft 
intermission: intermission 
ever: ever 
digital: digital 
sun: sun 
complex: complex 
starz: starz 
hot: hot 
kilhoffer: kilhoffer 
ultimate: ultimate 
replying: replying 
wrong: wrong 
mirikazizi: mirikazizi 
like: like 
super: super 
distinguish: distinguish 
painfully: painfully 
trust: trust 
chop: chop 
cover: covers 
highlight: highlights 
kanye: kanye 
fuck: fuck 
frank: frank 
liberated: liberated 
source: source 
sign: sign 
q: q 
beam: beam 
pop: pop 
r: r 
noise: noise 
spanish: spanish 
asked: asked 
gladstone: gladstone 
llc: llc 
supplication: supplication 
insight: insight 
expand: expand 
big: big 
luxury: luxury 
feel: feel 
portuguese: portuguese 
pa: pas 
peder: peder 
kafka: kafka 
repeating: repeating 
iz: iz 
track: track 
mispronounced: mispronounced 
peermusic: peermusic 
remind: remind 
publishing: publishing 
work: work 
owe: owe 
date: date 
platinum: platinum 
c: c 
skin: skin 
waking: waking 
sorry: sorry 
interview: interview 
h: h 
individual: individual 
exclusive: exclusive 
certification: certifications 
respect: respect 
pnb: pnb 
shoot: shoot 
everybody: everybody 
know: know 
personal: personal 
transcription: transcription 
chillpill: chillpill 
chart: charts 
might: might 
pedl: pedl 
pre: pre 
sueco: sueco 
toasty: toasty 
mr: mr 
canadiana: canadiana 
expressing: expressing 
warner: warner 
vocal: vocals 
italian: italian 
music: music 
l: l 
comedy: comedy 
kid: kid 
bu: bu 
question: question 
producer: producer 
something: something 
drop: drop 
shop: shop 
espa: espa 
produced: produced 
learn: learn 
fsmh: fsmh 
saint: saint 
verse: verse 
anthony: anthony 
young: young 
unwanted: unwanted 
italiana: italiana 
scholar: scholars 
drake: drake 
fire: fire 
siiiiiiiiilver: siiiiiiiiilver 
goldstein: goldstein 
lol: lol 
slight: slight 
viva: viva 
interpolation: interpolations 
aresa: aresa 
keke: keke 
mixx: mixx 
version: version 
traduzioni: traduzioni 
cranio: cranio 
yusef: yusef 
entertainment: entertainment 
italiano: italiano 
atv: atv 
abramus: abramus 
