talk: talk 
tradu: tradu 
hang: hang 
bitch: bitch bitches 
italic: italics 
chorus: chorus 
note: note 
belief: believes 
section: section 
time: times time 
girl: girl girls 
nobody: nobody 
dec: dec 
let: let 
nigga: nigga niggas 
team: team 
good: good 
roc: roc 
remixes: remixes 
released: released 
model: models 
collection: collection 
phonix: phonix 
interpolates: interpolates 
tell: tell 
use: use 
bird: bird 
lyric: lyrics lyric 
touch: touch 
role: role 
nia: nia 
deep: deep 
put: put 
information: information 
conflicted: conflicted 
apparently: apparently 
particularly: particularly 
tribe: tribe 
w: w 
six: six 
world: world 
holding: holdings 
making: making 
devdsnow: devdsnow 
v: v 
twice: twice 
aaliyah: aaliyah 
third: third 
shallow: shallow 
back: back 
wanna: wanna 
phil: phil 
rubbed: rubbed 
fulfilled: fulfilled 
fox: fox 
prod: prod 
privacy: privacy 
artist: artists 
want: want 
toquel: toquel 
ayy: ayy 
bout: bout 
token: token 
loved: loved 
go: go 
beat: beats beat 
discretion: discretion 
modelz: modelz 
knew: knew 
empty: empty 
another: another 
ca: ca 
talentless: talentless 
answer: answer 
plaque: plaque 
rowlan: rowlan 
share: share 
uncle: uncle 
never: never 
k: k 
luther: luther 
think: think 
guideline: guidelines 
check: check 
song: song songs 
credit: credits 
chopper: chopper 
viv: viv 
cole: cole 
man: man 
nomination: nomination 
even: even 
engineer: engineer 
happy: happy 
rich: rich 
aunt: aunt 
fooled: fooled 
real: real 
songview: songview 
comment: comment comments 
tour: tour 
truth: truth 
fool: fool 
speech: speech 
contributor: contributor contributors 
hi: hi 
read: read 
english: english 
riaa: riaa 
part: parts part 
background: background 
header: headers 
right: right rights 
indulges: indulges 
ask: ask 
written: written 
performance: performance performances 
format: format 
vocalist: vocalists 
developer: developers 
probably: probably 
bridge: bridge 
sweatin: sweatin 
haha: haha 
fore: fore 
remix: remix 
mixing: mixing 
regret: regret 
view: view 
musical: musical 
visit: visit 
though: though 
kaye: kaye 
lust: lust 
italiano: italiano 
created: created 
studio: studio studios 
tennessee: tennessee 
theme: theme 
p: p 
call: call 
whether: whether 
hook: hook 
broken: broken 
different: different 
shot: shot 
vida: vida 
e: es e 
video: videos video 
story: stories 
pussy: pussy 
crunchy: crunchy 
featured: featured 
album: album 
tag: tags 
sampled: sampled 
word: words 
home: home 
label: label 
started: started 
clip: clip 
pat: pat 
ascap: ascap 
al: al 
takin: takin 
got: got 
mez: mez 
george: george 
type: type 
searchin: searchin 
b: b 
release: release 
defensive: defensive 
wadn: wadn 
prolly: prolly 
hill: hills 
would: would 
bmi: bmi 
intro: intro 
sade: sade 
show: shows 
x: x 
one: one 
transcriber: transcribers 
night: night 
peace: peace 
flirt: flirt 
policy: policy 
reality: reality 
etc: etc 
sell: sell 
could: could 
texas: texas 
portugu: portugu 
paul: paul 
foot: feet 
sister: sisters 
annotation: annotation 
listen: listen 
wonder: wonder 
broke: broke 
along: along 
father: father 
polish: polish 
dahi: dahi 
wood: wood 
genius: genius 
millz: millz 
sample: samples sample 
juicy: juicy 
everestt: everestt 
purpose: purpose 
press: press 
russian: russian 
five: five 
freestyle: freestyle 
rap: rap 
sound: sound 
light: lights 
long: long 
columbia: columbia 
booklet: booklet 
u: u us 
lay: lay 
heavily: heavily 
n: n 
verified: verified 
toothbrush: toothbrush 
rise: rise 
g: g 
face: face 
spoiled: spoiled 
phone: phone 
blame: blame 
left: left 
knowledge: knowledge 
absolute: absolute 
bop: bop 
make: make 
yourz: yourz 
death: death 
line: lines 
brasil: brasil 
licensing: licensing 
j: j 
assistant: assistant 
forest: forest 
th: th 
sean: sean 
italiane: italiane 
ol: ol 
forum: forum 
traducciones: traducciones 
fan: fan 
said: said 
dreamville: dreamville 
difference: difference 
advertise: advertise 
adolescence: adolescence 
additional: additional 
add: add 
saying: saying 
hey: hey 
adu: adu 
understand: understand 
guide: guide 
rain: rain 
wet: wet 
swear: swear 
traduzione: traduzione 
mila: mila 
jada: jada 
promote: promote 
save: save 
hip: hip 
tale: tale 
melody: melody 
job: jobs 
biggest: biggest 
copyright: copyright 
bold: bold 
bonet: bonet 
f: f 
old: old 
stale: stale 
shirt: shirt 
crib: crib 
rest: rest 
saved: saved 
contact: contact 
em: em 
squad: squad 
clear: clear 
ml: ml 
juro: juro 
production: production 
also: also 
get: get 
came: came 
lisa: lisa 
translation: translations translation 
traducci: traducci 
know: knows know 
misc: misc 
celebrity: celebrity 
white: white 
hello: hello 
nation: nation 
comin: comin 
fact: facts 
interlude: interlude 
wire: wire 
ton: ton 
thing: things 
ho: ho 
cancel: cancel 
trap: trap 
z: z 
trace: traces 
wear: wear 
president: president 
way: way 
project: project 
made: made 
self: self 
nah: nah 
woulda: woulda 
january: january 
callin: callin 
term: terms 
without: without 
thought: thought 
hoe: hoes 
bringin: bringin 
take: take 
black: black 
skirt: skirt 
skinned: skinned 
suga: suga 
interpolate: interpolate 
god: god 
hop: hop 
la: la 
response: response 
kick: kick 
embed: embed 
first: first 
dreamz: dreamz 
ft: ft 
last: last 
ever: ever 
fame: fame 
hot: hot 
three: three 
ultimate: ultimate 
pregnant: pregnant 
lame: lame 
bush: bush 
fourth: fourth 
like: like 
distinguish: distinguish 
ville: ville 
better: better 
shame: shame 
fuck: fuck 
papiraraw: papiraraw 
angeles: angeles 
source: source 
leave: leave 
need: need 
hand: hand 
sign: sign 
q: q 
davis: davis 
stay: stay 
r: r 
favorite: favorite 
load: load 
spanish: spanish 
proceed: proceed 
llc: llc 
insight: insight 
memory: memory 
expand: expand 
recording: recording 
script: script 
portuguese: portuguese 
already: already 
los: los 
repeating: repeating 
dark: dark 
trina: trina 
track: track 
love: love 
hit: hit 
find: find 
growing: growing 
behind: behind 
tropez: tropez 
date: date 
platinum: platinum 
hollywood: hollywood 
c: c 
fast: fast 
conscious: conscious 
martin: martin 
sorry: sorry 
greystone: greystone 
h: h 
individual: individual 
neighborhood: neighborhoods 
prophecy: prophecies 
certification: certifications 
cause: cause 
single: single 
perfect: perfect 
personal: personal 
transcription: transcription 
chart: charts 
might: might 
citiez: citiez 
pre: pre 
yeah: yeah 
inspiration: inspiration 
list: list 
vocal: vocals 
materialistic: materialistic 
record: records 
gettin: gettin 
star: stars 
italian: italian 
music: music 
l: l 
drive: drive 
live: live 
kid: kid 
br: br 
question: question 
mafia: mafia 
speak: speak 
baddest: baddest 
gotta: gotta 
drop: drop 
shop: shop 
espa: espa 
produced: produced 
learn: learn 
king: king 
deserved: deserved 
tv: tv 
verse: verse 
young: young 
cristal: cristal 
recorded: recorded 
st: st 
italiana: italiana 
dj: dj 
scholar: scholars 
fire: fire 
december: december 
viva: viva 
legit: legit 
interpolation: interpolations 
traduzioni: traduzioni 
say: says 
ill: ill 
kellett: kellett 
