guy: guys 
nico: nico 
damn: damn 
tradu: tradu 
foreign: foreign 
jackhoeting: jackhoeting 
famous: famous 
italic: italics 
around: around 
chorus: chorus 
nfkrz: nfkrz 
misread: misread 
still: still 
section: section 
time: times time 
girl: girl girls 
kiss: kiss 
february: february 
deutsch: deutsch 
good: good 
remixes: remixes 
look: looks 
info: info 
collection: collection 
ybn: ybn 
use: use 
goodbye: goodbye 
grip: grip 
lyric: lyrics lyric 
bad: bad 
wash: washes 
outro: outro 
information: information 
mia: mia 
w: w 
explain: explain 
world: world 
holding: holdings 
rewind: rewind 
dab: dab 
v: v 
page: page 
back: back 
actress: actress 
acrylo: acrylo 
privacy: privacy 
artist: artists 
want: want 
loved: loved 
porn: porn 
go: go 
bro: bro 
another: another 
mdfashionco: mdfashionco 
dick: dick 
eviri: eviri 
answer: answer 
share: share 
never: never 
k: k 
think: think 
guideline: guidelines 
pdx: pdx 
check: check 
song: song songs 
credit: credits 
showing: showing 
nicer: nicer 
deutsche: deutsche 
boyfriend: boyfriend 
rrr: rrr 
mashups: mashups 
even: even 
engineer: engineer 
eat: eat 
real: real 
comment: comment comments 
participation: participation 
contributor: contributor contributors 
waterfall: waterfall 
actually: actually 
smv: smv 
read: read 
mess: mess 
meme: memes meme 
lil: lil 
english: english 
part: parts part 
past: past 
header: headers 
quit: quit 
ask: ask 
written: written 
performance: performance 
format: format 
vocalist: vocalists 
developer: developers 
changed: changed 
bridge: bridge 
flip: flip 
september: september 
remix: remix 
rk: rk 
mixing: mixing 
view: view 
musical: musical 
visit: visit 
created: created 
boomin: boomin 
khalifa: khalifa 
johnnascus: johnnascus 
responded: responded 
p: p 
play: play 
ooh: ooh 
uh: uh 
web: web 
call: call 
broken: broken 
different: different 
fight: fight 
star: star 
e: es e 
video: videos video 
pussy: pussy 
win: win 
featured: featured 
tag: tags 
grant: grants 
label: label 
parody: parody 
pat: pat 
ascap: ascap 
memory: memories 
al: al 
job: job jobs 
got: got 
wiz: wiz 
type: type 
lip: lip 
mosquito: mosquito 
release: release 
b: b 
misali: misali 
minecraft: minecraft 
right: rights 
intro: intro 
brr: brr 
x: x 
one: one 
transcriber: transcribers 
deleted: deleted 
lot: lot 
precious: precious 
ryuuseigun: ryuuseigun 
policy: policy 
washed: washed 
publisher: publisher 
etc: etc 
sell: sell 
friend: friends 
portugu: portugu 
tiko: tiko 
anthem: anthem 
shot: shots 
click: click 
used: used 
annotation: annotation 
october: october 
yazawa: yazawa 
bet: bet 
life: lives 
flat: flat 
instagram: instagram 
posted: posted 
image: image 
genius: genius 
sample: samples sample 
year: year 
press: press 
russian: russian 
freestyle: freestyle 
cosplaying: cosplaying 
rap: rap 
bersetzungen: bersetzungen 
long: long 
fired: fired 
crackhead: crackhead 
gon: gon 
tiktok: tiktok 
u: u us 
sometimes: sometimes 
verified: verified 
n: n 
g: g 
tired: tired 
referred: referred 
retired: retired 
knowledge: knowledge 
every: every 
death: death 
hijabi: hijabi 
line: lines 
rezwrld: rezwrld 
brasil: brasil 
licensing: licensing 
j: j 
sucking: sucking 
german: german 
ol: ol 
forum: forum 
late: late 
traducciones: traducciones 
said: said 
mad: mad 
advertise: advertise 
add: add 
ilovefriday: ilovefriday 
synching: synching 
understand: understand 
guide: guide 
rather: rather 
josh: josh 
twitter: twitter 
bruhmanegod: bruhmanegod 
approach: approach 
mkbhd: mkbhd 
school: school 
handbrajeans: handbrajeans 
promote: promote 
tire: tire 
wish: wish 
biggest: biggest 
copyright: copyright 
bold: bold 
yuh: yuh 
f: f 
trashpump: trashpump 
cover: cover covers 
contact: contact 
whilst: whilst 
situation: situation 
em: em 
turkish: turkish 
iq: iq 
ml: ml 
jan: jan 
disambiguation: disambiguation 
also: also 
get: get 
decade: decade 
translation: translations translation 
jayy: jayy 
traducci: traducci 
regret: regrets 
goat: goats 
bersetzung: bersetzung 
body: body 
ball: balls 
fact: facts 
fake: fake 
gained: gained 
tweet: tweet 
thing: things 
mood: mood 
youtube: youtube 
gucci: gucci 
eww: eww 
reaction: reaction 
cancel: cancel 
idol: idol 
mwah: mwah 
z: z 
resurgence: resurgence 
cursed: cursed 
mode: mode 
leader: leader 
project: project 
vincent: vincent 
missy: missy 
made: made 
level: level 
term: terms 
popularity: popularity 
take: take 
tok: tok 
interpolate: interpolate 
motif: motives 
embed: embed 
disease: disease 
whole: whole 
first: first 
zoomer: zoomer 
tried: tried 
ft: ft 
grandayy: grandayy 
galaxy: galaxy 
hot: hot 
three: three 
since: since 
ultimate: ultimate 
well: well 
like: like 
super: super 
distinguish: distinguish 
yxngxr: yxngxr 
removed: removed 
fuck: fuck 
huh: huh 
source: source 
carr: carr 
bang: bangs 
sign: sign 
flyingkitty: flyingkitty 
q: q 
pop: pop 
r: r 
place: place 
industry: industry 
spanish: spanish 
smith: smith 
llc: llc 
insight: insight 
ya: ya 
expand: expand 
aqsa: aqsa 
big: big 
recording: recording 
portuguese: portuguese 
kitty: kitty 
repeating: repeating 
dark: dark 
track: track 
love: love 
hit: hit 
schacht: schacht 
find: find 
behind: behind 
work: work 
pewdiepie: pewdiepie 
date: date 
skrrt: skrrt 
c: c 
xeno: xeno 
beef: beef 
megamix: megamix 
tic: tic 
mashup: mashup 
h: h 
individual: individual 
cause: cause 
smoke: smoke 
know: know 
moment: moments 
perfect: perfect 
adult: adult 
personal: personal 
baller: baller 
transcription: transcription 
chart: charts 
might: might 
hedless: hedless 
fifa: fifa 
brother: brothers 
dis: diss 
warner: warner 
vydia: vydia 
music: music 
miss: miss 
l: l 
flop: flop 
live: live 
question: question 
something: something 
drop: drop 
gotta: gotta 
shop: shop 
espa: espa 
produced: produced 
notoriety: notoriety 
learn: learn 
car: car 
verse: verse 
whataburger: whataburger 
young: young 
nyannyancosplay: nyannyancosplay 
scholar: scholars 
seen: seen 
gregory: gregory 
guess: guess 
film: film 
dissing: dissing 
dolan: dolan 
